E&MJ-ENGINEERING AND MINING JOURNAL = ENG MIN J
EAR AND HEARING = EAR HEARING
EAR NOSE & THROAT JOURNAL = EAR NOSE THROAT J
EARLY AMERICAN LITERATURE = EARLY AM LITERATURE
EARLY CHILDHOOD RESEARCH QUARTERLY = EARLY CHILD RES Q
EARLY DEVELOPMENT & PARENTING = EARLY DEV PARENTING
EARLY HUMAN DEVELOPMENT = EARLY HUM DEV
EARLY MUSIC = EARLY MUSIC
EARLY MUSIC HISTORY = EARLY MUSIC HIST
EARTH AND PLANETARY SCIENCE LETTERS = EARTH PLANET SC LETT
EARTH ISLAND JOURNAL = EARTH ISL J
EARTH MOON AND PLANETS = EARTH MOON PLANETS
EARTH OBSERVATION AND REMOTE SENSING = EARTH OBS REMOT SEN+
EARTH PLANETS AND SPACE = EARTH PLANETS SPACE
EARTH SCIENCE = EARTH SCI
EARTH SURFACE PROCESSES AND LANDFORMS = EARTH SURF PROC LAND
EARTH SURFACE PROCESSES AND LANDFORMS = EARTH SURF PROCESSES
EARTH-ORIENTED APPLICATIONS OF SPACE TECHNOLOGY = EARTH-ORIENT SP TECH
EARTH-SCIENCE REVIEWS = EARTH-SCI REV
EARTHQUAKE ENGINEERING & STRUCTURAL DYNAMICS = EARTHQUAKE ENG STRUC
EARTHQUAKE PREDICTION RESEARCH = EARTHQUAKE PRED RES
EAST AFRICAN MEDICAL JOURNAL = E AFR MED J
EAST EUROPEAN POLITICS AND SOCIETIES = E EUR POLIT SOC
EAST EUROPEAN QUARTERLY = E EUR QUART
EAST-WEST FILM JOURNAL = EAST-WEST FILM J
EASTERN BUDDHIST = EASTERN BUDDHIST
EASTERN EUROPEAN ECONOMICS = EASTERN EUR ECON
EAU DU QUEBEC = EAU QUEBEC
EC&M-ELECTRICAL CONSTRUCTION AND MAINTENANCE = ECM-ELECTR CONSTR M
ECHOCARDIOGRAPHY-A JOURNAL OF CARDIOVASCULAR ULTRASOUND AND ALLIED TECHNIQUES = ECHOCARDIOGR-J CARD
ECLETICA QUIMICA = ECLET QUIM
ECLOGAE GEOLOGICAE HELVETIAE = ECLOGAE GEOL HELV
ECOGRAPHY = ECOGRAPHY
ECOLOGICAL APPLICATIONS = ECOL APPL
ECOLOGICAL BULLETINS = ECOL BULL
ECOLOGICAL ECONOMICS = ECOL ECON
ECOLOGICAL ENGINEERING = ECOL ENG
ECOLOGICAL ENTOMOLOGY = ECOL ENTOMOL
ECOLOGICAL MODELLING = ECOL MODEL
ECOLOGICAL MONOGRAPHS = ECOL MONOGR
ECOLOGICAL PSYCHOLOGY = ECOL PSYCHOL
ECOLOGICAL RESEARCH = ECOL RES
ECOLOGICAL STUDIES = ECOL STUD
ECOLOGIST = ECOLOGIST
ECOLOGY = ECOLOGY
ECOLOGY LAW QUARTERLY = ECOL LAW QUART
ECOLOGY LETTERS = ECOL LETT
ECOLOGY OF FOOD AND NUTRITION = ECOL FOOD NUTR
ECOLOGY OF FRESHWATER FISH = ECOL FRESHW FISH
ECONOMETRIC THEORY = ECONOMET THEOR
ECONOMETRICA = ECONOMETRICA
ECONOMIC AND INDUSTRIAL DEMOCRACY = ECON IND DEMOCRACY
ECONOMIC AND POLITICAL WEEKLY = ECON POLIT WEEKLY
ECONOMIC AND SOCIAL REVIEW = ECON SOC REV
ECONOMIC BOTANY = ECON BOT
ECONOMIC DEVELOPMENT AND CULTURAL CHANGE = ECON DEV CULT CHANGE
ECONOMIC DEVELOPMENT QUARTERLY = ECON DEV Q
ECONOMIC GEOGRAPHY = ECON GEOGR
ECONOMIC GEOLOGY = ECON GEOL
ECONOMIC GEOLOGY AND THE BULLETIN OF THE SOCIETY OF ECONOMIC GEOLOGISTS = ECON GEOL BULL SOC
ECONOMIC HISTORY REVIEW = ECON HIST REV
ECONOMIC INQUIRY = ECON INQ
ECONOMIC JOURNAL = ECON J
ECONOMIC MODELLING = ECON MODEL
ECONOMIC PLANNING = ECON PLANN-CANADA
ECONOMIC POLICY = ECON POLICY
ECONOMIC RECORD = ECON REC
ECONOMIC THEORY = ECON THEOR
ECONOMIC THEORY = ECON THEORY
ECONOMICA = ECONOMICA
ECONOMICS AND PHILOSOPHY = ECON PHILOS
ECONOMICS LETTERS = ECON LETT
ECONOMICS OF EDUCATION REVIEW = ECON EDUC REV
ECONOMICS OF PLANNING = ECON PLANN
ECONOMICS OF TRANSITION = ECON TRANSIT
ECONOMIST = ECONOMIST
ECONOMY AND SOCIETY = ECON SOC
ECONTENT = ECONTENT
ECOSCIENCE = ECOSCIENCE
ECOSYSTEM HEALTH = ECOSYST HEALTH
ECOSYSTEMS = ECOSYSTEMS
ECOTOXICOLOGY = ECOTOXICOLOGY
ECOTOXICOLOGY AND ENVIRONMENTAL SAFETY = ECOTOX ENVIRON SAFE
ECUMENE = ECUMENE
ECUMENICAL REVIEW = ECUMENICAL REV
EDF LETTER = EDF LETT
EDN = EDN
EDN MAGAZINE-ELECTRICAL DESIGN NEWS = EDN
EDP ANALYZER = EDP ANAL
EDUCATION AND TRAINING IN MENTAL RETARDATION AND DEVELOPMENTAL DISABILITIES = EDUC TRAIN MENT RET
EDUCATION AND URBAN SOCIETY = EDUC URBAN SOC
EDUCATION FOR INFORMATION = EDUC INFORM
EDUCATIONAL & TRAINING TECHNOLOGY INTERNATIONAL = EDUC TRAIN TECHNOL
EDUCATIONAL ADMINISTRATION QUARTERLY = EDUC ADMIN QUART
EDUCATIONAL AND PSYCHOLOGICAL MEASUREMENT = EDUC PSYCHOL MEAS
EDUCATIONAL EVALUATION AND POLICY ANALYSIS = EDUC EVAL POLICY AN
EDUCATIONAL GERONTOLOGY = EDUC GERONTOL
EDUCATIONAL LEADERSHIP = EDUC LEADERSHIP
EDUCATIONAL POLICY = EDUC POLICY
EDUCATIONAL PSYCHOLOGIST = EDUC PSYCHOL
EDUCATIONAL PSYCHOLOGY REVIEW = EDUC PSYCHOL REV
EDUCATIONAL RESEARCH = EDUC RES
EDUCATIONAL REVIEW = EDUC REV
EDUCATIONAL STUDIES = EDUC STUD
EE-EVALUATION ENGINEERING = EE-EVAL ENG
EEG-EMG-ZEITSCHRIFT FUR ELEKTROENZEPHALOGRAPHIE ELEKTROMYOGRAPHIE UND VERWANDTE GEBIETE = EEG-EMG-Z ELEK ELEKT
EFFLUENT & WATER TREATMENT JOURNAL = EFFLUENT WATER TREAT
EGYPTIAN JOURNAL OF GENETICS AND CYTOLOGY = EGYPT J GENET CYTOL
EICOSANOIDS = EICOSANOIDS
EIGHTEENTH CENTURY-THEORY AND INTERPRETATION = EIGHTEENTH CENT-THEO
EIGHTEENTH-CENTURY LIFE = EIGHTEENTH-CENT LIFE
EIGHTEENTH-CENTURY STUDIES = EIGHTEENTH-CENT STUD
EIGSE-A JOURNAL OF IRISH STUDIES = EIGSE-J IRISH STUD
EIRE-IRELAND = EIRE-IRELAND
EISEI KAGAKU-JAPANESE JOURNAL OF TOXICOLOGY AND ENVIRONMENTAL HEALTH = EISEI KAGAKU
EKOLOGIA CSFR = EKOL CSFR
EKOLOGIA POLSKA-POLISH JOURNAL OF ECOLOGY = EKOL POL-POL J ECOL
EKOLOGIA-BRATISLAVA = EKOL BRATISLAVA
EKONOMICKY CASOPIS = EKON CAS
EKONOMISKA SAMFUNDETS TIDSKRIFT = EKON SAMF TIDSKR
EKSPERIMENTALNAYA ONKOLOGIYA = EKSP ONKOL
ELASTOMERICS = ELASTOMERICS
ELECTORAL STUDIES = ELECT STUD
ELECTRIC MACHINES AND ELECTROMECHANICS = ELECTR MACH ELECTROM
ELECTRIC MACHINES AND POWER SYSTEMS = ELECTR MACH POW SYST
ELECTRIC POWER SYSTEMS RESEARCH = ELECTR POW SYST RES
ELECTRICAL COMMUNICATION = ELECTR COMMUN
ELECTRICAL ENGINEERING = ELECTR ENG
ELECTRICAL ENGINEERING IN JAPAN = ELECTR ENG JPN
ELECTRICAL TECHNOLOGY = ELECTR TECHNOL+
ELECTRICAL TECHNOLOGY RUSSIA = ELECTR TECHNOL RUSS+
ELECTRICAL WORLD = ELECTR WORLD
ELECTRO- AND MAGNETOBIOLOGY = ELECTRO MAGNETOBIOL
ELECTRO-OPTICAL SYSTEMS DESIGN = ELECTR OPT SYST DES
ELECTRO-OPTICS = ELECTRO-OPTICS
ELECTROANALYSIS = ELECTROANAL
ELECTROANALYTICAL CHEMISTRY = ELECTROANAL CHEM
ELECTROCHEMICAL AND SOLID STATE LETTERS = ELECTROCHEM SOLID ST
ELECTROCHEMISTRY = ELECTROCHEMISTRY
ELECTROCHEMISTRY COMMUNICATIONS = ELECTROCHEM COMMUN
ELECTROCHIMICA ACTA = ELECTROCHIM ACTA
ELECTROCOMPONENT SCIENCE AND TECHNOLOGY = ELECTROCOMP SCI TECH
ELECTROENCEPHALOGRAPHY AND CLINICAL NEUROPHYSIOLOGY = ELECTROEN CLIN NEURO
ELECTROMAGNETICS = ELECTROMAGNETICS
ELECTROMYOGRAPHY AND MOTOR CONTROL-ELECTROENCEPHALOGRAPHY AND CLINICAL NEUROPHYSIOLOGY = ELECTROMYOGR MOTOR C
ELECTRON DEVICE LETTERS = ELECTRON DEVIC LETT
ELECTRON MICROSCOPY REVIEWS = ELECTRON MICROSC REV
ELECTRON SPIN RESONANCE-A SPECIALIST PERIODICAL REPORT = ELECTRON SPIN RESON
ELECTRONIC DESIGN = ELECTRON DES
ELECTRONIC ENGINEERING = ELECTRON ENG
ELECTRONIC JOURNAL OF THEORETICAL CHEMISTRY = ELECTRON J THEOR CH
ELECTRONIC LIBRARY = ELECTRON LIBR
ELECTRONIC PRODUCT DESIGN = ELECTRON PROD DES
ELECTRONIC PRODUCTS MAGAZINE = ELECTRON PROD
ELECTRONIC RESEARCH ANNOUNCEMENTS OF THE AMERICAN MATHEMATICAL SOCIETY = ELECTRON RES ANNOUNC
ELECTRONICS = ELECTRONICS
ELECTRONICS & COMMUNICATION ENGINEERING JOURNAL = ELECTRON COMMUN ENG
ELECTRONICS & WIRELESS WORLD = ELECTRON WIRELESS W
ELECTRONICS AND COMMUNICATIONS IN JAPAN PART I-COMMUNICATIONS = ELECTRON COMM JPN 1
ELECTRONICS AND COMMUNICATIONS IN JAPAN PART II-ELECTRONICS = ELECTRON COMM JPN 2
ELECTRONICS AND COMMUNICATIONS IN JAPAN PART III-FUNDAMENTAL ELECTRONIC SCIENCE = ELECTRON COMM JPN 3
ELECTRONICS AND POWER = ELECTRON POWER
ELECTRONICS INFORMATION & PLANNING = ELECTRON INFORM PLAN
ELECTRONICS LETTERS = ELECTRON LETT
ELECTRONICS WORLD = ELECTRON WORLD
ELECTRONICS WORLD & WIRELESS WORLD = ELECTRON WORLD WIREL
ELECTRONICSWEEK = ELECTRONICS
ELECTROPHORESIS = ELECTROPHORESIS
ELELMEZESI IPAR = ELELMEZESI IPAR
ELEMENTA-JOURNAL OF SLAVIC STUDIES & COMPARATIVE CULTURAL SEMIOTICS = ELEMENTA
ELEMENTARY SCHOOL JOURNAL = ELEM SCHOOL J
ELETTROTECNICA = ELETTROTECNICA
ELH-ENGLISH LITERARY HISTORY = ELH-ENGL LIT HIST
EMBO JOURNAL = EMBO J
EMERGENCY MEDICAL SERVICES = EMERGEN MED SERV
EMERGENCY MEDICINE = EMERGEN MED
EMERGENCY MEDICINE CLINICS OF NORTH AMERICA = EMERG MED CLIN N AM
EMERGING INFECTIOUS DISEASES = EMERG INFECT DIS
EMPLOYEE RELATIONS LAW JOURNAL = EMPLOYEE RELAT LAW J
EMU = EMU
ENANTIOMER = ENANTIOMER
ENCEPHALE-REVUE DE PSYCHIATRIE CLINIQUE BIOLOGIQUE ET THERAPEUTIQUE = ENCEPHALE
ENDEAVOUR = ENDEAVOUR
ENDOCRINE = ENDOCRINE
ENDOCRINE JOURNAL = ENDOCR J
ENDOCRINE PATHOLOGY = ENDOCR PATHOL
ENDOCRINE RESEARCH = ENDOCR RES
ENDOCRINE RESEARCH COMMUNICATIONS = ENDOCR RES COMMUN
ENDOCRINE REVIEWS = ENDOCR REV
ENDOCRINE-RELATED CANCER = ENDOCR-RELAT CANCER
ENDOCRINOLOGIA EXPERIMENTALIS = ENDOCRINOL EXP
ENDOCRINOLOGIA JAPONICA = ENDOCRINOL JAPON
ENDOCRINOLOGIST = ENDOCRINOLOGIST
ENDOCRINOLOGY = ENDOCRINOLOGY
ENDOCRINOLOGY AND METABOLISM = ENDOCRINOL METAB
ENDOCRINOLOGY AND METABOLISM CLINICS OF NORTH AMERICA = ENDOCRIN METAB CLIN
ENDOCYTOBIOSIS AND CELL RESEARCH = ENDOCYT CELL RES
ENDODONTICS & DENTAL TRAUMATOLOGY = ENDOD DENT TRAUMATOL
ENDOKRINOLOGIE = ENDOKRINOLOGIE
ENDOSCOPY = ENDOSCOPY
ENDOTHELIUM-NEW YORK = ENDOTHELIUM-NEW YORK
ENERGIA ES ATOMTECHNIKA = ENERG ATOMTECH
ENERGIETECHNIK = ENERGIETECHNIK
ENERGY = ENERGY
ENERGY & FUELS = ENERG FUEL
ENERGY AND BUILDINGS = ENERG BUILDINGS
ENERGY COMMUNICATIONS = ENERG COMMUN
ENERGY CONVERSION AND MANAGEMENT = ENERG CONVERS MANAGE
ENERGY ECONOMICS = ENERG ECON
ENERGY ENGINEERING = ENERG ENG
ENERGY EXPLORATION & EXPLOITATION = ENERG EXPLOR EXPLOIT
ENERGY IN AGRICULTURE = ENERG AGR
ENERGY JOURNAL = ENERGY J
ENERGY POLICY = ENERG POLICY
ENERGY SOURCES = ENERG SOURCE
ENGINEER = ENGINEER-LONDON
ENGINEERING = ENGINEERING-LONDON
ENGINEERING ANALYSIS WITH BOUNDARY ELEMENTS = ENG ANAL BOUND ELEM
ENGINEERING APPLICATIONS OF ARTIFICIAL INTELLIGENCE = ENG APPL ARTIF INTEL
ENGINEERING COMPUTATIONS = ENG COMPUTATION
ENGINEERING COSTS AND PRODUCTION ECONOMICS = ENG COST PROD ECON
ENGINEERING CYBERNETICS = ENG CYBERN
ENGINEERING DIGEST = ENG DIG
ENGINEERING EDUCATION = ENG EDUC
ENGINEERING FAILURE ANALYSIS = ENG FAIL ANAL
ENGINEERING FRACTURE MECHANICS = ENG FRACT MECH
ENGINEERING GEOLOGY = ENG GEOL
ENGINEERING INTELLIGENT SYSTEMS FOR ELECTRICAL ENGINEERING AND COMMUNICATIONS = ENG INTELL SYST ELEC
ENGINEERING JOURNAL = ENG J-CANADA
ENGINEERING JOURNAL-AMERICAN INSTITUTE OF STEEL CONSTRUCTION INC = ENG J AISC
ENGINEERING MANAGEMENT INTERNATIONAL = ENG MANAGE INT
ENGINEERING NEWS-RECORD = ENG NEWS-REC
ENGINEERING OPTIMIZATION = ENG OPTIMIZ
ENGINEERING PLASTICS = ENG PLAST
ENGINEERING STRUCTURES = ENG STRUCT
ENGINEERING WITH COMPUTERS = ENG COMPUT
ENGLISH = ENGLISH
ENGLISH HISTORICAL REVIEW = ENGL HIST REV
ENGLISH IN AFRICA = ENGL AFR
ENGLISH LANGUAGE NOTES = ENGL LANG NOTES
ENGLISH LITERARY RENAISSANCE = ENGL LITERARY RENAIS
ENGLISH LITERATURE IN TRANSITION 1880-1920 = ENGL LIT TRANSITION
ENGLISH STUDIES = ENGL STUD
ENGLISH STUDIES IN AFRICA = ENGL STUD AFR
ENGLISH STUDIES IN CANADA = ENGL STUD CAN
ENTERTAINMENT DESIGN = ENTERTAIN DES
ENTOMOLOGIA EXPERIMENTALIS ET APPLICATA = ENTOMOL EXP APPL
ENTOMOLOGIA GENERALIS = ENTOMOL GEN
ENTOMOLOGICA FENNICA = ENTOMOL FENNICA
ENTOMOLOGICA SCANDINAVICA = ENTOMOL SCAND
ENTOMOLOGICAL NEWS = ENTOMOL NEWS
ENTOMON = ENTOMON
ENTOMOPHAGA = ENTOMOPHAGA
ENVIRONMENT = ENVIRONMENT
ENVIRONMENT AND BEHAVIOR = ENVIRON BEHAV
ENVIRONMENT AND PLANNING A = ENVIRON PLANN A
ENVIRONMENT AND PLANNING B-PLANNING & DESIGN = ENVIRON PLANN B
ENVIRONMENT AND PLANNING C-GOVERNMENT AND POLICY = ENVIRON PLANN C
ENVIRONMENT AND PLANNING D-SOCIETY & SPACE = ENVIRON PLANN D
ENVIRONMENT AND URBANIZATION = ENVIRON URBAN
ENVIRONMENT INTERNATIONAL = ENVIRON INT
ENVIRONMENTAL & ENGINEERING GEOSCIENCE = ENVIRON ENG GEOSCI
ENVIRONMENTAL & RESOURCE ECONOMICS = ENVIRON RESOUR ECON
ENVIRONMENTAL AND ECOLOGICAL STATISTICS = ENVIRON ECOL STAT
ENVIRONMENTAL AND EXPERIMENTAL BOTANY = ENVIRON EXP BOT
ENVIRONMENTAL AND MOLECULAR MUTAGENESIS = ENVIRON MOL MUTAGEN
ENVIRONMENTAL AND SOCIAL EFFECTS OF TRANSPORTATION = TRANSPORT RES REC
ENVIRONMENTAL BIOLOGY OF FISHES = ENVIRON BIOL FISH
ENVIRONMENTAL CARCINOGENESIS & ECOTOXICOLOGY REVIEWS-PART C OF JOURNAL OF ENVIRONMENTAL SCIENCE AND HEALTH = ENVIRON CARCIN ECO R
ENVIRONMENTAL CARCINOGENESIS REVIEWS-PART C OF JOURNAL OF ENVIRONMENTAL SCIENCE AND HEALTH = ENVIRON CARCIN ECO R
ENVIRONMENTAL CARCINOGENESIS REVIEWS-PART C OF JOURNAL OF ENVIRONMENTAL SCIENCE AND HEALTH = ENVIRON CARCINOG REV
ENVIRONMENTAL CLAIMS JOURNAL = ENVIRON CLAIM J
ENVIRONMENTAL CONSERVATION = ENVIRON CONSERV
ENVIRONMENTAL ENGINEERING SCIENCE = ENVIRON ENG SCI
ENVIRONMENTAL ENTOMOLOGY = ENVIRON ENTOMOL
ENVIRONMENTAL ETHICS = ENVIRON ETHICS
ENVIRONMENTAL GEOCHEMISTRY AND HEALTH = ENVIRON GEOCHEM HLTH
ENVIRONMENTAL GEOLOGY = ENVIRON GEOL
ENVIRONMENTAL GEOLOGY AND WATER SCIENCES = ENVIRON GEOL WATER S
ENVIRONMENTAL HEALTH PERSPECTIVES = ENVIRON HEALTH PERSP
ENVIRONMENTAL HISTORY = ENVIRON HIST
ENVIRONMENTAL IMPACT ASSESSMENT REVIEW = ENVIRON IMPACT ASSES
ENVIRONMENTAL MANAGEMENT = ENVIRON MANAGE
ENVIRONMENTAL MICROBIOLOGY = ENVIRON MICROBIOL
ENVIRONMENTAL MODELING & ASSESSMENT = ENVIRON MODEL ASSESS
ENVIRONMENTAL MODELLING & SOFTWARE = ENVIRON MODELL SOFTW
ENVIRONMENTAL MONITORING AND ASSESSMENT = ENVIRON MONIT ASSESS
ENVIRONMENTAL MUTAGENESIS = ENVIRON MOL MUTAGEN
ENVIRONMENTAL MUTAGENESIS = ENVIRON MUTAGEN
ENVIRONMENTAL POLLUTION = ENVIRON POLLUT
ENVIRONMENTAL POLLUTION SERIES A-ECOLOGICAL AND BIOLOGICAL = ENVIRON POLLUT A
ENVIRONMENTAL POLLUTION SERIES B-CHEMICAL AND PHYSICAL = ENVIRON POLLUT B
ENVIRONMENTAL PROGRESS = ENVIRON PROG
ENVIRONMENTAL RESEARCH = ENVIRON RES
ENVIRONMENTAL SCIENCE & TECHNOLOGY = ENVIRON SCI TECHNOL
ENVIRONMENTAL SCIENCE AND POLLUTION RESEARCH = ENVIRON SCI POLLUT R
ENVIRONMENTAL SOFTWARE = ENVIRON SOFTW
ENVIRONMENTAL TECHNOLOGY = ENVIRON TECHNOL
ENVIRONMENTAL TECHNOLOGY LETTERS = ENVIRON TECHNOL LETT
ENVIRONMENTAL TOXICOLOGY = ENVIRON TOXICOL
ENVIRONMENTAL TOXICOLOGY AND CHEMISTRY = ENVIRON TOXICOL CHEM
ENVIRONMENTAL TOXICOLOGY AND PHARMACOLOGY = ENVIRON TOXICOL PHAR
ENVIRONMENTAL TOXICOLOGY AND WATER QUALITY = ENVIRON TOXIC WATER
ENVIRONMENTAL VALUES = ENVIRON VALUE
ENVIRONMENTALIST = ENVIRONMENTALIST
ENVIRONMETRICS = ENVIRONMETRICS
ENZYME = ENZYME
ENZYME & PROTEIN = ENZYME PROTEIN
ENZYME AND MICROBIAL TECHNOLOGY = ENZYME MICROB TECH
ENZYME ENGINEERING = ENZYME ENG
EOS-RIVISTA DI IMMUNOLOGIA ED IMMUNOFARMACOLOGIA = EOS-RIV IMMUNOL
EPIDEMIOLOGIC REVIEWS = EPIDEMIOL REV
EPIDEMIOLOGY = EPIDEMIOLOGY
EPIDEMIOLOGY AND INFECTION = EPIDEMIOL INFECT
EPILEPSIA = EPILEPSIA
EPILEPSY RESEARCH = EPILEPSY RES
EPILEPTIC DISORDERS = EPILEPTIC DISORD
EPISODES = EPISODES
EPITHELIAL CELL BIOLOGY = EPITHELIAL CELL BIOL
EPRI JOURNAL = EPRI J
EQUINE ATHLETE = EQUINE ATHLETE
EQUINE PRACTICE = EQUINE PRACT
EQUINE VETERINARY EDUCATION = EQUINE VET EDUC
EQUINE VETERINARY JOURNAL = EQUINE VET J
ERDOL & KOHLE ERDGAS PETROCHEMIE = ERDOL KOHLE ERDGAS P
ERGODIC THEORY AND DYNAMICAL SYSTEMS = ERGOD THEOR DYN SYST
ERGONOMICS = ERGONOMICS
ERICSSON REVIEW = ERICSSON REV
ERNAHRUNGS-UMSCHAU = ERNAHRUNGS-UMSCHAU
ESA BULLETIN-EUROPEAN SPACE AGENCY = ESA BULL-EUR SPACE
ESA JOURNAL-EUROPEAN SPACE AGENCY = ESA J-EUR SPACE AGEN
ESAIM-MATHEMATICAL MODELLING AND NUMERICAL ANALYSIS-MODELISATION MATHEMATIQUE ET ANALYSE NUMERIQUE = ESAIM-MATH MODEL NUM
ESPRIT = ESPRIT
ESPRIT CREATEUR = ESPRIT CREATEUR
ESQ-A JOURNAL OF THE AMERICAN RENAISSANCE = ESQ-J AM RENAISSANCE
ESSAYS IN BIOCHEMISTRY = ESSAYS BIOCHEM
ESSAYS IN CRITICISM = ESSAYS CRITICISM
ESSAYS IN LITERATURE = ESSAYS LITERATURE
ESSAYS IN POETICS = ESSAYS POETICS
ESSAYS IN THEATRE-ETUDES THEATRALES = ESSAYS THEAT
ESSAYS ON CANADIAN WRITING = ESSAYS CAN WRIT
ESTRENO-CUADERNOS DEL TEATRO ESPANOL CONTEMPORANEO = ESTRENO
ESTUARIES = ESTUARIES
ESTUARINE COASTAL AND SHELF SCIENCE = ESTUAR COAST SHELF S
ESTUDIOS CLASICOS = ESTUD CLASICO
ESTUDIOS FILOLOGICOS = ESTUD FILOL
ESTUDOS IBERO-AMERICANOS = ESTUD IBERO-AM
ETHICS = ETHICS
ETHICS & BEHAVIOR = ETHICS BEHAV
ETHIOPIAN MEDICAL JOURNAL = ETHIOPIAN MED J
ETHNIC AND RACIAL STUDIES = ETHNIC RACIAL STUD
ETHNOHISTORY = ETHNOHISTORY
ETHNOLOGY = ETHNOLOGY
ETHNOMUSICOLOGY = ETHNOMUSICOLOGY
ETHOLOGY = ETHOLOGY
ETHOLOGY AND SOCIOBIOLOGY = ETHOL SOCIOBIOL
ETHOLOGY ECOLOGY & EVOLUTION = ETHOL ECOL EVOL
ETHOS = ETHOS
ETR&D-EDUCATIONAL TECHNOLOGY RESEARCH AND DEVELOPMENT = ETR&D-EDUC TECH RES
ETRI JOURNAL = ETRI J
ETUDES ANGLAISES = ETUD ANGLAISES
ETUDES CINEMATOGRAPHIQUES = ETUD CINEMA
ETUDES CLASSIQUES = ETUD CLASSIQUES
ETUDES FRANCAISES = ETUD FR
ETUDES GERMANIQUES = ETUD GER
ETUDES IRLANDAISES = ETUD IRLANDAISES
ETUDES LITTERAIRES = ETUD LITTERAIRES
ETUDES PHILOSOPHIQUES = ETUD PHILOS
ETUDES THEOLOGIQUES ET RELIGIEUSES = ETUD THEOL RELIG
ETZ ARCHIV = ETZ ARCHIV
EUPHORION-ZEITSCHRIFT FUR LITERATURGESCHICHTE = EUPHORION-Z LIT
EUPHYTICA = EUPHYTICA
EURASIAN SOIL SCIENCE = EURASIAN SOIL SCI+
EUROPA ARCHIV = EUR ARCH
EUROPACE = EUROPACE
EUROPE-ASIA STUDIES = EUROPE-ASIA STUD
EUROPE-REVUE LITTERAIRE MENSUELLE = EUROPE-REV LIT MENS
EUROPEAN ADDICTION RESEARCH = EUR ADDICT RES
EUROPEAN ARCHIVES OF OTO-RHINO-LARYNGOLOGY = EUR ARCH OTO-RHINO-L
EUROPEAN ARCHIVES OF PSYCHIATRY AND CLINICAL NEUROSCIENCE = EUR ARCH PSY CLIN N
EUROPEAN BIOPHYSICS JOURNAL = EUR BIOPHYS J
EUROPEAN BIOPHYSICS JOURNAL WITH BIOPHYSICS LETTERS = EUR BIOPHYS J BIOPHY
EUROPEAN CANCER NEWS = EUR CANC NEW
EUROPEAN CANCER NEWS = EUR CANCER NEWS
EUROPEAN CHEMICAL NEWS = EUR CHEM NEWS
EUROPEAN CHILD & ADOLESCENT PSYCHIATRY = EUR CHILD ADOLES PSY
EUROPEAN CYTOKINE NETWORK = EUR CYTOKINE NETW
EUROPEAN EATING DISORDERS REVIEW = EUR EAT DISORD REV
EUROPEAN ECONOMIC REVIEW = EUR ECON REV
EUROPEAN FOOD RESEARCH AND TECHNOLOGY = EUR FOOD RES TECHNOL
EUROPEAN HEART JOURNAL = EUR HEART J
EUROPEAN HEART JOURNAL SUPPLEMENTS = EUR HEART J SUPPL
EUROPEAN HISTORY QUARTERLY = EUR HIST Q
EUROPEAN JOURNAL OF AGRONOMY = EUR J AGRON
EUROPEAN JOURNAL OF ANAESTHESIOLOGY = EUR J ANAESTHESIOL
EUROPEAN JOURNAL OF APPLIED MATHEMATICS = EUR J APPL MATH
EUROPEAN JOURNAL OF APPLIED MICROBIOLOGY AND BIOTECHNOLOGY = EUR J APPL MICROBIOL
EUROPEAN JOURNAL OF APPLIED PHYSIOLOGY = EUR J APPL PHYSIOL
EUROPEAN JOURNAL OF APPLIED PHYSIOLOGY AND OCCUPATIONAL PHYSIOLOGY = EUR J APPL PHYSIOL O
EUROPEAN JOURNAL OF BASIC AND APPLIED HISTOCHEMISTRY = EUR J BASIC APPL HIS
EUROPEAN JOURNAL OF BIOCHEMISTRY = EUR J BIOCHEM
EUROPEAN JOURNAL OF CANCER = EUR J CANCER
EUROPEAN JOURNAL OF CANCER & CLINICAL ONCOLOGY = EUR J CANCER CLIN ON
EUROPEAN JOURNAL OF CANCER CARE = EUR J CANCER CARE
EUROPEAN JOURNAL OF CANCER PREVENTION = EUR J CANCER PREV
EUROPEAN JOURNAL OF CARDIO-THORACIC SURGERY = EUR J CARDIO-THORAC
EUROPEAN JOURNAL OF CELL BIOLOGY = EUR J CELL BIOL
EUROPEAN JOURNAL OF CLINICAL CHEMISTRY AND CLINICAL BIOCHEMISTRY = EUR J CLIN CHEM CLIN
EUROPEAN JOURNAL OF CLINICAL INVESTIGATION = EUR J CLIN INVEST
EUROPEAN JOURNAL OF CLINICAL MICROBIOLOGY & INFECTIOUS DISEASES = EUR J CLIN MICROBIOL
EUROPEAN JOURNAL OF CLINICAL NUTRITION = EUR J CLIN NUTR
EUROPEAN JOURNAL OF CLINICAL PHARMACOLOGY = EUR J CLIN PHARMACOL
EUROPEAN JOURNAL OF COGNITIVE PSYCHOLOGY = EUR J COGN PSYCHOL
EUROPEAN JOURNAL OF COMBINATORICS = EUR J COMBIN
EUROPEAN JOURNAL OF COMMUNICATION = EUR J COMMUN
EUROPEAN JOURNAL OF CONTROL = EUR J CONTROL
EUROPEAN JOURNAL OF DERMATOLOGY = EUR J DERMATOL
EUROPEAN JOURNAL OF DISORDERS OF COMMUNICATION = EUR J DISORDER COMM
EUROPEAN JOURNAL OF DRUG METABOLISM AND PHARMACOKINETICS = EUR J DRUG METAB PH
EUROPEAN JOURNAL OF ENDOCRINOLOGY = EUR J ENDOCRINOL
EUROPEAN JOURNAL OF ENTOMOLOGY = EUR J ENTOMOL
EUROPEAN JOURNAL OF EPIDEMIOLOGY = EUR J EPIDEMIOL
EUROPEAN JOURNAL OF FOREST PATHOLOGY = EUR J FOREST PATHOL
EUROPEAN JOURNAL OF GASTROENTEROLOGY & HEPATOLOGY = EUR J GASTROEN HEPAT
EUROPEAN JOURNAL OF GYNAECOLOGICAL ONCOLOGY = EUR J GYNAECOL ONCOL
EUROPEAN JOURNAL OF HAEMATOLOGY = EUR J HAEMATOL
EUROPEAN JOURNAL OF HEART FAILURE = EUR J HEART FAIL
EUROPEAN JOURNAL OF HISTOCHEMISTRY = EUR J HISTOCHEM
EUROPEAN JOURNAL OF HUMAN GENETICS = EUR J HUM GENET
EUROPEAN JOURNAL OF IMMUNOGENETICS = EUR J IMMUNOGENET
EUROPEAN JOURNAL OF IMMUNOLOGY = EUR J IMMUNOL
EUROPEAN JOURNAL OF INDUSTRIAL RELATIONS = EUR J IND RELAT
EUROPEAN JOURNAL OF INFORMATION SYSTEMS = EUR J INFORM SYST
EUROPEAN JOURNAL OF INORGANIC CHEMISTRY = EUR J INORG CHEM
EUROPEAN JOURNAL OF INTERNATIONAL RELATIONS = EUR J INT RELAT
EUROPEAN JOURNAL OF LIPID SCIENCE AND TECHNOLOGY = EUR J LIPID SCI TECH
EUROPEAN JOURNAL OF MECHANICS A-SOLIDS = EUR J MECH A-SOLID
EUROPEAN JOURNAL OF MECHANICS B-FLUIDS = EUR J MECH B-FLUID
EUROPEAN JOURNAL OF MEDICINAL CHEMISTRY = EUR J MED CHEM
EUROPEAN JOURNAL OF MINERALOGY = EUR J MINERAL
EUROPEAN JOURNAL OF MORPHOLOGY = EUR J MORPHOL
EUROPEAN JOURNAL OF NEUROLOGY = EUR J NEUROL
EUROPEAN JOURNAL OF NEUROSCIENCE = EUR J NEUROSCI
EUROPEAN JOURNAL OF NUCLEAR MEDICINE = EUR J NUCL MED
EUROPEAN JOURNAL OF NUTRITION = EUR J NUTR
EUROPEAN JOURNAL OF OBSTETRICS GYNECOLOGY AND REPRODUCTIVE BIOLOGY = EUR J OBSTET GYN R B
EUROPEAN JOURNAL OF OPERATIONAL RESEARCH = EUR J OPER RES
EUROPEAN JOURNAL OF OPHTHALMOLOGY = EUR J OPHTHALMOL
EUROPEAN JOURNAL OF ORAL SCIENCES = EUR J ORAL SCI
EUROPEAN JOURNAL OF ORGANIC CHEMISTRY = EUR J ORG CHEM
EUROPEAN JOURNAL OF ORTHODONTICS = EUR J ORTHODONT
EUROPEAN JOURNAL OF PAIN-LONDON = EUR J PAIN-LONDON
EUROPEAN JOURNAL OF PEDIATRIC SURGERY = EUR J PEDIATR SURG
EUROPEAN JOURNAL OF PEDIATRICS = EUR J PEDIATR
EUROPEAN JOURNAL OF PERSONALITY = EUR J PERSONALITY
EUROPEAN JOURNAL OF PHARMACEUTICAL SCIENCES = EUR J PHARM SCI
EUROPEAN JOURNAL OF PHARMACEUTICS AND BIOPHARMACEUTICS = EUR J PHARM BIOPHARM
EUROPEAN JOURNAL OF PHARMACOLOGY = EUR J PHARMACOL
EUROPEAN JOURNAL OF PHARMACOLOGY-ENVIRONMENTAL TOXICOLOGY AND PHARMACOLOGY SECTION = EUR J PHARM-ENVIRON
EUROPEAN JOURNAL OF PHARMACOLOGY-MOLECULAR PHARMACOLOGY SECTION = EUR J PHARM-MOLEC PH
EUROPEAN JOURNAL OF PHILOSOPHY = EUR J PHILOS
EUROPEAN JOURNAL OF PHYCOLOGY = EUR J PHYCOL
EUROPEAN JOURNAL OF PLANT PATHOLOGY = EUR J PLANT PATHOL
EUROPEAN JOURNAL OF PLASTIC SURGERY = EUR J PLAST SURG
EUROPEAN JOURNAL OF POLITICAL RESEARCH = EUR J POLIT RES
EUROPEAN JOURNAL OF POPULATION-REVUE EUROPEENNE DE DEMOGRAPHIE = EUR J POPUL
EUROPEAN JOURNAL OF PROTISTOLOGY = EUR J PROTISTOL
EUROPEAN JOURNAL OF PSYCHIATRY = EUR J PSYCHIAT
EUROPEAN JOURNAL OF PSYCHOLOGICAL ASSESSMENT = EUR J PSYCHOL ASSESS
EUROPEAN JOURNAL OF PSYCHOLOGY OF EDUCATION = EUR J PSYCHOL EDUC
EUROPEAN JOURNAL OF PUBLIC HEALTH = EUR J PUBLIC HEALTH
EUROPEAN JOURNAL OF RADIOLOGY = EUR J RADIOL
EUROPEAN JOURNAL OF RESPIRATORY DISEASES = EUR J RESPIR DIS
EUROPEAN JOURNAL OF RHEUMATOLOGY AND INFLAMMATION = EUR J RHEUMATOL INFL
EUROPEAN JOURNAL OF SEXUALLY TRANSMITTED DISEASES = EUR J SEX TRANSM DIS
EUROPEAN JOURNAL OF SOCIAL PSYCHOLOGY = EUR J SOC PSYCHOL
EUROPEAN JOURNAL OF SOIL BIOLOGY = EUR J SOIL BIOL
EUROPEAN JOURNAL OF SOIL SCIENCE = EUR J SOIL SCI
EUROPEAN JOURNAL OF SOLID STATE AND INORGANIC CHEMISTRY = EUR J SOL STATE INOR
EUROPEAN JOURNAL OF SURGERY = EUR J SURG
EUROPEAN JOURNAL OF SURGICAL ONCOLOGY = EUR J SURG ONCOL
EUROPEAN JOURNAL OF VASCULAR AND ENDOVASCULAR SURGERY = EUR J VASC ENDOVASC
EUROPEAN JOURNAL OF VASCULAR SURGERY = EUR J VASCULAR SURG
EUROPEAN JOURNAL OF WOMENS STUDIES = EUR J WOMENS STUD
EUROPEAN MASS SPECTROMETRY = EUR MASS SPECTROM
EUROPEAN NEUROLOGY = EUR NEUROL
EUROPEAN NEUROPSYCHOPHARMACOLOGY = EUR NEUROPSYCHOPHARM
EUROPEAN PAEDIATRIC HAEMATOLOGY AND ONCOLOGY = EUR PAEDIATR HAEMAT
EUROPEAN PHYSICAL JOURNAL A = EUR PHYS J A
EUROPEAN PHYSICAL JOURNAL B = EUR PHYS J B
EUROPEAN PHYSICAL JOURNAL C = EUR PHYS J C
EUROPEAN PHYSICAL JOURNAL D = EUR PHYS J D
EUROPEAN PHYSICAL JOURNAL-APPLIED PHYSICS = EUR PHYS J-APPL PHYS
EUROPEAN POLYMER JOURNAL = EUR POLYM J
EUROPEAN PSYCHIATRY = EUR PSYCHIAT
EUROPEAN RADIOLOGY = EUR RADIOL
EUROPEAN RESPIRATORY JOURNAL = EUR RESPIR J
EUROPEAN REVIEW OF AGRICULTURAL ECONOMICS = EUR REV AGRIC ECON
EUROPEAN REVIEW OF APPLIED PSYCHOLOGY-REVUE EUROPEENNE DE PSYCHOLOGIE APPLIQUEE = EUR REV APPL PSYCHOL
EUROPEAN SOCIOLOGICAL REVIEW = EUR SOCIOL REV
EUROPEAN SPECTROSCOPY NEWS = EUR SPECTROSC NEWS
EUROPEAN SPINE JOURNAL = EUR SPINE J
EUROPEAN SURGICAL RESEARCH = EUR SURG RES
EUROPEAN TRANSACTIONS ON ELECTRICAL POWER = EUR T ELECTR POWER
EUROPEAN TRANSACTIONS ON ELECTRICAL POWER ENGINEERING = EUR T ELECTR POW
EUROPEAN TRANSACTIONS ON TELECOMMUNICATIONS = EUR T TELECOMMUN
EUROPEAN URBAN AND REGIONAL STUDIES = EUR URBAN REG STUD
EUROPEAN UROLOGY = EUR UROL
EUROPHYSICS LETTERS = EUROPHYS LETT
EVALUATION & THE HEALTH PROFESSIONS = EVAL HEALTH PROF
EVALUATION AND PROGRAM PLANNING = EVAL PROGRAM PLANN
EVALUATION PRACTICE = EVAL PRACT
EVALUATION REVIEW = EVALUATION REV
EVOKED POTENTIALS-ELECTROENCEPHALOGRAPHY AND CLINICAL NEUROPHYSIOLOGY = EVOKED POTENTIAL
EVOLUTION = EVOLUTION
EVOLUTION & DEVELOPMENT = EVOL DEV
EVOLUTION AND HUMAN BEHAVIOR = EVOL HUM BEHAV
EVOLUTION PSYCHIATRIQUE = EVOL PSYCHIATR
EVOLUTIONARY ANTHROPOLOGY = EVOL ANTHROPOL
EVOLUTIONARY BIOLOGY = EVOL BIOL
EVOLUTIONARY ECOLOGY = EVOL ECOL
EVOLUTIONARY ECOLOGY RESEARCH = EVOL ECOL RES
EVOLUTIONARY THEORY = EVOL THEOR
EVOLUTIONARY TRENDS IN PLANTS = EVOL TREND PLANT
EXCEPTIONAL CHILDREN = EXCEPT CHILDREN
EXCITED STATES = EXCITED STATES
EXERCISE AND SPORT SCIENCES REVIEWS = EXERCISE SPORT SCI R
EXERCISE AND SPORT SCIENCES REVIEWS, VOLUME 28, 1998 = EXERCISE SPORT SCI R
EXERCISE IMMUNOLOGY REVIEW = EXERC IMMUNOL REV
EXERCISE STANDARDS AND MALPRACTICE REPORTER = EXERC STAND MALPRACT
EXOTIC PET PRACTICE = EXOT PET PRACT
EXPERIENTIA = EXPERIENTIA
EXPERIMENTAL & APPLIED ACAROLOGY = EXP APPL ACAROL
EXPERIMENTAL AGING RESEARCH = EXP AGING RES
EXPERIMENTAL AGRICULTURE = EXP AGR
EXPERIMENTAL AND APPLIED ACAROLOGY = EXP APPL ACAROL
EXPERIMENTAL AND CLINICAL ENDOCRINOLOGY = EXP CLIN ENDOCRINOL
EXPERIMENTAL AND CLINICAL ENDOCRINOLOGY & DIABETES = EXP CLIN ENDOCR DIAB
EXPERIMENTAL AND CLINICAL IMMUNOGENETICS = EXP CLIN IMMUNOGENET
EXPERIMENTAL AND CLINICAL PSYCHOPHARMACOLOGY = EXP CLIN PSYCHOPHARM
EXPERIMENTAL AND MOLECULAR MEDICINE = EXP MOL MED
EXPERIMENTAL AND MOLECULAR PATHOLOGY = EXP MOL PATHOL
EXPERIMENTAL AND TOXICOLOGIC PATHOLOGY = EXP TOXICOL PATHOL
EXPERIMENTAL ANIMALS = EXP ANIM TOKYO
EXPERIMENTAL ASTRONOMY = EXP ASTRON
EXPERIMENTAL BIOLOGY = EXP BIOL
EXPERIMENTAL BRAIN RESEARCH = EXP BRAIN RES
EXPERIMENTAL CELL BIOLOGY = EXP CELL BIOL
EXPERIMENTAL CELL RESEARCH = EXP CELL RES
EXPERIMENTAL DERMATOLOGY = EXP DERMATOL
EXPERIMENTAL EYE RESEARCH = EXP EYE RES
EXPERIMENTAL GERONTOLOGY = EXP GERONTOL
EXPERIMENTAL HEAT TRANSFER = EXP HEAT TRANSFER
EXPERIMENTAL HEMATOLOGY = EXP HEMATOL
EXPERIMENTAL HORTICULTURE = EXP HORTIC
EXPERIMENTAL LUNG RESEARCH = EXP LUNG RES
EXPERIMENTAL MATHEMATICS = EXP MATH
EXPERIMENTAL MECHANICS = EXP MECH
EXPERIMENTAL MYCOLOGY = EXP MYCOL
EXPERIMENTAL NEPHROLOGY = EXP NEPHROL
EXPERIMENTAL NEUROLOGY = EXP NEUROL
EXPERIMENTAL ONCOLOGY = EXP ONCOL
EXPERIMENTAL PARASITOLOGY = EXP PARASITOL
EXPERIMENTAL PATHOLOGY = EXP PATHOL-JENA
EXPERIMENTAL PHYSIOLOGY = EXP PHYSIOL
EXPERIMENTAL TECHNIQUES = EXP TECHNIQUES
EXPERIMENTAL THERMAL AND FLUID SCIENCE = EXP THERM FLUID SCI
EXPERIMENTS IN CATALYTIC REACTION ENGINEERING = STUD SURF SCI CATAL
EXPERIMENTS IN FLUIDS = EXP FLUIDS
EXPERT OPINION ON THERAPEUTIC PATENTS = EXPERT OPIN THER PAT
EXPERT SYSTEMS = EXPERT SYST
EXPERT SYSTEMS WITH APPLICATIONS = EXPERT SYST APPL
EXPLICACION DE TEXTOS LITERARIOS = EXPL TEXTOS LIT
EXPLICATOR = EXPLICATOR
EXPLOITATION OF FINE-GRAIN PARALLELISM = LECT NOTES COMPUT SC
EXPLORATION AND MINING GEOLOGY = EXPLOR MIN GEOL
EXPLORATIONS IN ECONOMIC HISTORY = EXPLOR ECON HIST
EXPOSITORY TIMES = EXPOSITORY TIMES
EXTRAPOLATION = EXTRAPOLATION
EXTREMOPHILES = EXTREMOPHILES
EYE = EYE
EYE-TRANSACTIONS OF THE OPHTHALMOLOGICAL SOCIETIES OF THE UNITED KINGDOM = EYE
