I&CS-CONTROL TECHNOLOGY FOR ENGINEERS AND ENGINEERING MANAGEMENT = I&CS-CONTROL TECH EN
I&CS-INDUSTRIAL AND PROCESS CONTROL MAGAZINE = I&CS-CONTROL TECH EN
I&CS-INSTRUMENTATION & CONTROL SYSTEMS = I&CS-INSTR CON SYST
I-S ANALYZER = I-S ANAL
IARC PUBLICATIONS = IARC PUBL
IARC SCIENTIFIC PUBLICATIONS = IARC SCI PUBL
IAU SYMPOSIA = IAU SYMP
IAWA BULLETIN = IAWA BULL
IAWA JOURNAL = IAWA J
IBEROROMANIA = IBEROROMANIA
IBIS = IBIS
IBM JOURNAL OF RESEARCH AND DEVELOPMENT = IBM J RES DEV
IBM SYSTEMS JOURNAL = IBM SYST J
ICARUS = ICARUS
ICCA JOURNAL = ICCA J
ICES JOURNAL OF MARINE SCIENCE = ICES J MAR SCI
ICGA JOURNAL = ICGA J
ICHTHYOLOGICAL RESEARCH = ICHTHYOL RES
ICID JOURNAL = ICID J
ICP BUSINESS SOFTWARE REVIEW = ICP BUS SOFTW REV
ICP SOFTWARE BUSINESS REVIEW = ICP BUS SOFTW REV
IDEALISTIC STUDIES = IDEALISTIC STUD
IDENTITIES-GLOBAL STUDIES IN CULTURE AND POWER = IDENTITIES-GLOB STUD
IDS BULLETIN-INSTITUTE OF DEVELOPMENT STUDIES = IDS BULL-I DEV STUD
IEE PROCEEDINGS-A-SCIENCE MEASUREMENT AND TECHNOLOGY = IEE PROC-A
IEE PROCEEDINGS-B ELECTRIC POWER APPLICATIONS = IEE PROC-B
IEE PROCEEDINGS-C GENERATION TRANSMISSION AND DISTRIBUTION = IEE PROC-C
IEE PROCEEDINGS-CIRCUITS DEVICES AND SYSTEMS = IEE P-CIRC DEV SYST
IEE PROCEEDINGS-COMMUNICATIONS = IEE P-COMMUN
IEE PROCEEDINGS-COMPUTERS AND DIGITAL TECHNIQUES = IEE P-COMPUT DIG T
IEE PROCEEDINGS-CONTROL THEORY AND APPLICATIONS = IEE P-CONTR THEOR AP
IEE PROCEEDINGS-D CONTROL THEORY AND APPLICATIONS = IEE PROC-D
IEE PROCEEDINGS-E COMPUTERS AND DIGITAL TECHNIQUES = IEE PROC-E
IEE PROCEEDINGS-ELECTRIC POWER APPLICATIONS = IEE P-ELECT POW APPL
IEE PROCEEDINGS-F RADAR AND SIGNAL PROCESSING = IEE PROC-F
IEE PROCEEDINGS-G CIRCUITS DEVICES AND SYSTEMS = IEE PROC-G
IEE PROCEEDINGS-GENERATION TRANSMISSION AND DISTRIBUTION = IEE P-GENER TRANSM D
IEE PROCEEDINGS-H MICROWAVES ANTENNAS AND PROPAGATION = IEE PROC-H
IEE PROCEEDINGS-I COMMUNICATIONS SPEECH AND VISION = IEE PROC-I
IEE PROCEEDINGS-J OPTOELECTRONICS = IEE PROC-J
IEE PROCEEDINGS-MICROWAVES ANTENNAS AND PROPAGATION = IEE P-MICROW ANTEN P
IEE PROCEEDINGS-OPTOELECTRONICS = IEE P-OPTOELECTRON
IEE PROCEEDINGS-RADAR SONAR AND NAVIGATION = IEE P-RADAR SON NAV
IEE PROCEEDINGS-SCIENCE MEASUREMENT AND TECHNOLOGY = IEE P-SCI MEAS TECH
IEE PROCEEDINGS-VISION IMAGE AND SIGNAL PROCESSING = IEE P-VIS IMAGE SIGN
IEE REVIEW = IEE REVIEW
IEEE AEROSPACE AND ELECTRONIC SYSTEMS MAGAZINE = IEEE AERO EL SYS MAG
IEEE ANNALS OF THE HISTORY OF COMPUTING = IEEE ANN HIST COMPUT
IEEE ANTENNAS AND PROPAGATION MAGAZINE = IEEE ANTENNAS PROPAG
IEEE CIRCUITS & DEVICES = IEEE CIRCUITS DEVICE
IEEE CIRCUITS AND DEVICES MAGAZINE = IEEE CIRCUIT DEVIC
IEEE COMMUNICATIONS LETTERS = IEEE COMMUN LETT
IEEE COMMUNICATIONS MAGAZINE = IEEE COMMUN MAG
IEEE COMPUTATIONAL SCIENCE & ENGINEERING = IEEE COMPUT SCI ENG
IEEE COMPUTER APPLICATIONS IN POWER = IEEE COMPUT APPL POW
IEEE COMPUTER GRAPHICS AND APPLICATIONS = IEEE COMPUT GRAPH
IEEE CONCURRENCY = IEEE CONCURR
IEEE CONTROL SYSTEMS MAGAZINE = IEEE CONTR SYST MAG
IEEE DESIGN & TEST OF COMPUTERS = IEEE DES TEST COMPUT
IEEE ELECTRICAL INSULATION MAGAZINE = IEEE ELECTR INSUL M
IEEE ELECTRON DEVICE LETTERS = IEEE ELECTR DEVICE L
IEEE ENGINEERING IN MEDICINE AND BIOLOGY MAGAZINE = IEEE ENG MED BIOL
IEEE EXPERT-INTELLIGENT SYSTEMS & THEIR APPLICATIONS = IEEE EXPERT
IEEE INDUSTRY APPLICATIONS MAGAZINE = IEEE IND APPL MAG
IEEE INSTRUMENTATION & MEASUREMENT MAGAZINE = IEEE INSTRU MEAS MAG
IEEE INTELLIGENT SYSTEMS & THEIR APPLICATIONS = IEEE INTELL SYST APP
IEEE INTERNET COMPUTING = IEEE INTERNET COMPUT
IEEE JOURNAL OF OCEANIC ENGINEERING = IEEE J OCEANIC ENG
IEEE JOURNAL OF QUANTUM ELECTRONICS = IEEE J QUANTUM ELECT
IEEE JOURNAL OF ROBOTICS AND AUTOMATION = IEEE T ROBOTIC AUTOM
IEEE JOURNAL OF SELECTED TOPICS IN QUANTUM ELECTRONICS = IEEE J SEL TOP QUANT
IEEE JOURNAL OF SOLID-STATE CIRCUITS = IEEE J SOLID-ST CIRC
IEEE JOURNAL ON SELECTED AREAS IN COMMUNICATIONS = IEEE J SEL AREA COMM
IEEE MICRO = IEEE MICRO
IEEE MICROWAVE AND GUIDED WAVE LETTERS = IEEE MICROW GUIDED W
IEEE MULTIMEDIA = IEEE MULTIMEDIA
IEEE NETWORK = IEEE NETWORK
IEEE PARALLEL & DISTRIBUTED TECHNOLOGY = IEEE PARALL DISTRIB
IEEE PERSONAL COMMUNICATIONS = IEEE PERS COMMUN
IEEE PHOTONICS TECHNOLOGY LETTERS = IEEE PHOTONIC TECH L
IEEE ROBOTICS & AUTOMATION MAGAZINE = IEEE ROBOT AUTOM MAG
IEEE SIGNAL PROCESSING LETTERS = IEEE SIGNAL PROC LET
IEEE SIGNAL PROCESSING MAGAZINE = IEEE SIGNAL PROC MAG
IEEE SOFTWARE = IEEE SOFTWARE
IEEE SPECTRUM = IEEE SPECTRUM
IEEE TECHNOLOGY AND SOCIETY MAGAZINE = IEEE TECHNOL SOC MAG
IEEE TRANSACTIONS ON ACOUSTICS SPEECH AND SIGNAL PROCESSING = IEEE T ACOUST SPEECH
IEEE TRANSACTIONS ON ADVANCED PACKAGING = IEEE TRANS ADV PACK
IEEE TRANSACTIONS ON AEROSPACE AND ELECTRONIC SYSTEMS = IEEE T AERO ELEC SYS
IEEE TRANSACTIONS ON ANTENNAS AND PROPAGATION = IEEE T ANTENN PROPAG
IEEE TRANSACTIONS ON APPLIED SUPERCONDUCTIVITY = IEEE T APPL SUPERCON
IEEE TRANSACTIONS ON AUTOMATIC CONTROL = IEEE T AUTOMAT CONTR
IEEE TRANSACTIONS ON BIOMEDICAL ENGINEERING = IEEE T BIO-MED ENG
IEEE TRANSACTIONS ON BROADCASTING = IEEE T BROADCAST
IEEE TRANSACTIONS ON CIRCUITS AND SYSTEMS = IEEE T CIRCUITS SYST
IEEE TRANSACTIONS ON CIRCUITS AND SYSTEMS FOR VIDEO TECHNOLOGY = IEEE T CIRC SYST VID
IEEE TRANSACTIONS ON CIRCUITS AND SYSTEMS I-FUNDAMENTAL THEORY AND APPLICATIONS = IEEE T CIRCUITS-I
IEEE TRANSACTIONS ON CIRCUITS AND SYSTEMS II-ANALOG AND DIGITAL SIGNAL PROCESSING = IEEE T CIRCUITS-II
IEEE TRANSACTIONS ON COMMUNICATIONS = IEEE T COMMUN
IEEE TRANSACTIONS ON COMPONENTS AND PACKAGING TECHNOLOGIES = IEEE T COMPON PACK T
IEEE TRANSACTIONS ON COMPONENTS HYBRIDS AND MANUFACTURING TECHNOLOGY = IEEE T COMPON HYBR
IEEE TRANSACTIONS ON COMPONENTS PACKAGING AND MANUFACTURING TECHNOLOGY PART A = IEEE T COMPON PACK A
IEEE TRANSACTIONS ON COMPONENTS PACKAGING AND MANUFACTURING TECHNOLOGY PART B-ADVANCED PACKAGING = IEEE T COMPON PACK B
IEEE TRANSACTIONS ON COMPUTER-AIDED DESIGN OF INTEGRATED CIRCUITS AND SYSTEMS = IEEE T COMPUT AID D
IEEE TRANSACTIONS ON COMPUTERS = IEEE T COMPUT
IEEE TRANSACTIONS ON CONSUMER ELECTRONICS = IEEE T CONSUM ELECTR
IEEE TRANSACTIONS ON CONTROL SYSTEMS TECHNOLOGY = IEEE T CONTR SYST T
IEEE TRANSACTIONS ON DIELECTRICS AND ELECTRICAL INSULATION = IEEE T DIELECT EL IN
IEEE TRANSACTIONS ON EDUCATION = IEEE T EDUC
IEEE TRANSACTIONS ON ELECTRICAL INSULATION = IEEE T ELECTR INSUL
IEEE TRANSACTIONS ON ELECTROMAGNETIC COMPATIBILITY = IEEE T ELECTROMAGN C
IEEE TRANSACTIONS ON ELECTRON DEVICES = IEEE T ELECTRON DEV
IEEE TRANSACTIONS ON ELECTRONICS PACKAGING MANUFACTURING = IEEE T ELECTRON PA M
IEEE TRANSACTIONS ON ENERGY CONVERSION = IEEE T ENERGY CONVER
IEEE TRANSACTIONS ON ENGINEERING MANAGEMENT = IEEE T ENG MANAGE
IEEE TRANSACTIONS ON EVOLUTIONARY COMPUTATION = IEEE T EVOLUT COMPUT
IEEE TRANSACTIONS ON FUZZY SYSTEMS = IEEE T FUZZY SYST
IEEE TRANSACTIONS ON GEOSCIENCE AND REMOTE SENSING = IEEE T GEOSCI REMOTE
IEEE TRANSACTIONS ON IMAGE PROCESSING = IEEE T IMAGE PROCESS
IEEE TRANSACTIONS ON INDUSTRIAL ELECTRONICS = IEEE T IND ELECTRON
IEEE TRANSACTIONS ON INDUSTRY APPLICATIONS = IEEE T IND APPL
IEEE TRANSACTIONS ON INFORMATION TECHNOLOGY IN BIOMEDICINE = IEEE T INF TECHNOL B
IEEE TRANSACTIONS ON INFORMATION THEORY = IEEE T INFORM THEORY
IEEE TRANSACTIONS ON INSTRUMENTATION AND MEASUREMENT = IEEE T INSTRUM MEAS
IEEE TRANSACTIONS ON KNOWLEDGE AND DATA ENGINEERING = IEEE T KNOWL DATA EN
IEEE TRANSACTIONS ON MAGNETICS = IEEE T MAGN
IEEE TRANSACTIONS ON MEDICAL IMAGING = IEEE T MED IMAGING
IEEE TRANSACTIONS ON MICROWAVE THEORY AND TECHNIQUES = IEEE T MICROW THEORY
IEEE TRANSACTIONS ON NEURAL NETWORKS = IEEE T NEURAL NETWOR
IEEE TRANSACTIONS ON NUCLEAR SCIENCE = IEEE T NUCL SCI
IEEE TRANSACTIONS ON PARALLEL AND DISTRIBUTED SYSTEMS = IEEE T PARALL DISTR
IEEE TRANSACTIONS ON PATTERN ANALYSIS AND MACHINE INTELLIGENCE = IEEE T PATTERN ANAL
IEEE TRANSACTIONS ON PLASMA SCIENCE = IEEE T PLASMA SCI
IEEE TRANSACTIONS ON POWER APPARATUS AND SYSTEMS = IEEE T POWER AP SYST
IEEE TRANSACTIONS ON POWER DELIVERY = IEEE T POWER DELIVER
IEEE TRANSACTIONS ON POWER ELECTRONICS = IEEE T POWER ELECTR
IEEE TRANSACTIONS ON POWER SYSTEMS = IEEE T POWER SYST
IEEE TRANSACTIONS ON PROFESSIONAL COMMUNICATION = IEEE T PROF COMMUN
IEEE TRANSACTIONS ON REHABILITATION ENGINEERING = IEEE T REHABIL ENG
IEEE TRANSACTIONS ON RELIABILITY = IEEE T RELIAB
IEEE TRANSACTIONS ON ROBOTICS AND AUTOMATION = IEEE T ROBOTIC AUTOM
IEEE TRANSACTIONS ON SEMICONDUCTOR MANUFACTURING = IEEE T SEMICONDUCT M
IEEE TRANSACTIONS ON SIGNAL PROCESSING = IEEE T SIGNAL PROCES
IEEE TRANSACTIONS ON SOFTWARE ENGINEERING = IEEE T SOFTWARE ENG
IEEE TRANSACTIONS ON SONICS AND ULTRASONICS = IEEE T SON ULTRASON
IEEE TRANSACTIONS ON SPEECH AND AUDIO PROCESSING = IEEE T SPEECH AUDI P
IEEE TRANSACTIONS ON SYSTEMS MAN AND CYBERNETICS = IEEE T SYST MAN CYB
IEEE TRANSACTIONS ON SYSTEMS MAN AND CYBERNETICS PART A-SYSTEMS AND HUMANS = IEEE T SYST MAN CY A
IEEE TRANSACTIONS ON SYSTEMS MAN AND CYBERNETICS PART B-CYBERNETICS = IEEE T SYST MAN CY B
IEEE TRANSACTIONS ON SYSTEMS MAN AND CYBERNETICS PART C-APPLICATIONS AND REVIEWS = IEEE T SYST MAN CY C
IEEE TRANSACTIONS ON ULTRASONICS FERROELECTRICS AND FREQUENCY CONTROL = IEEE T ULTRASON FERR
IEEE TRANSACTIONS ON VEHICULAR TECHNOLOGY = IEEE T VEH TECHNOL
IEEE TRANSACTIONS ON VERY LARGE SCALE INTEGRATION VLSI SYSTEMS = IEEE T VLSI SYST
IEEE TRANSACTIONS ON VISUALIZATION AND COMPUTER GRAPHICS = IEEE T VIS COMPUT GR
IEEE-ACM TRANSACTIONS ON NETWORKING = IEEE ACM T NETWORK
IEEE-ASME TRANSACTIONS ON MECHATRONICS = IEEE-ASME T MECH
IEICE TRANSACTIONS ON COMMUNICATIONS = IEICE T COMMUN
IEICE TRANSACTIONS ON COMMUNICATIONS ELECTRONICS INFORMATION AND SYSTEMS = IEICE TRANS COMMUN
IEICE TRANSACTIONS ON ELECTRONICS = IEICE T ELECTRON
IEICE TRANSACTIONS ON FUNDAMENTALS OF ELECTRONICS COMMUNICATIONS AND COMPUTER SCIENCES = IEICE T FUND ELECTR
IEICE TRANSACTIONS ON INFORMATION AND SYSTEMS = IEICE T INF SYST
IETE JOURNAL OF RESEARCH = IETE J RES
IETE TECHNICAL REVIEW = IETE TECH REV
IFIP TRANSACTIONS A-COMPUTER SCIENCE AND TECHNOLOGY = IFIP TRANS A
IFIP TRANSACTIONS B-APPLICATIONS IN TECHNOLOGY = IFIP TRANS B
IFIP TRANSACTIONS C-COMMUNICATION SYSTEMS = IFIP TRANS C
IFLA JOURNAL-INTERNATIONAL FEDERATION OF LIBRARY ASSOCIATIONS = IFLA J-INT FED LIBR
IIC-INTERNATIONAL REVIEW OF INDUSTRIAL PROPERTY AND COPYRIGHT LAW = IIC-INT REV IND PROP
IIE SOLUTIONS = IIE SOLUTIONS
IIE TRANSACTIONS = IIE TRANS
ILLAHEE-JOURNAL FOR THE NORTHWEST ENVIRONMENT = ILLAHEE
ILLINOIS AGRICULTURAL EXPERIMENT STATION BULLETIN = ILLINOIS AES BULL
ILLINOIS JOURNAL OF MATHEMATICS = ILLINOIS J MATH
ILLINOIS MEDICAL JOURNAL = ILLINOIS MED J
ILLINOIS RESEARCH = ILLINOIS RES
IMA JOURNAL OF APPLIED MATHEMATICS = IMA J APPL MATH
IMA JOURNAL OF MATHEMATICAL CONTROL AND INFORMATION = IMA J MATH CONTROL I
IMA JOURNAL OF MATHEMATICS APPLIED IN MEDICINE AND BIOLOGY = IMA J MATH APPL MED
IMA JOURNAL OF NUMERICAL ANALYSIS = IMA J NUMER ANAL
IMAGE = IMAGE
IMAGE AND VISION COMPUTING = IMAGE VISION COMPUT
IMAGING SCIENCE JOURNAL = IMAGING SCI J
IMMANUEL = IMMANUEL
IMMUNITAT UND INFEKTION = IMMUN INFEKT
IMMUNITY = IMMUNITY
IMMUNOBIOLOGY = IMMUNOBIOLOGY
IMMUNOGENETICS = IMMUNOGENETICS
IMMUNOLOGIC RESEARCH = IMMUNOL RES
IMMUNOLOGICAL COMMUNICATIONS = IMMUNOL COMMUN
IMMUNOLOGICAL INVESTIGATIONS = IMMUNOL INVEST
IMMUNOLOGICAL REVIEWS = IMMUNOL REV
IMMUNOLOGIST = IMMUNOLOGIST
IMMUNOLOGY = IMMUNOLOGY
IMMUNOLOGY AND ALLERGY CLINICS OF NORTH AMERICA = IMMUNOL ALLERGY CLIN
IMMUNOLOGY AND CELL BIOLOGY = IMMUNOL CELL BIOL
IMMUNOLOGY LETTERS = IMMUNOL LETT
IMMUNOLOGY TODAY = IMMUNOL TODAY
IMMUNOPARASITOLOGY TODAY-A COMBINED ISSUE OF IMMUNOLOGY TODAY AND PARASITOLOGY TODAY = IMMUNOPARASITOL TOD
IMMUNOPHARMACOLOGY = IMMUNOPHARMACOLOGY
IMMUNOPHARMACOLOGY AND IMMUNOTOXICOLOGY = IMMUNOPHARM IMMUNOT
IMMUNOTECHNOLOGY = IMMUNOTECHNOLOGY
IMPACT OF SCIENCE ON SOCIETY = IMPACT SCI SOC
IN PRACTICE = IN PRACTICE
IN SESSION-PSYCHOTHERAPY IN PRACTICE = IN SESSION-PSYCHOTH
IN SITU = IN SITU
IN VITRO & MOLECULAR TOXICOLOGY-A JOURNAL OF BASIC AND APPLIED RESEARCH = IN VITRO MOL TOXICOL
IN VITRO CELLULAR & DEVELOPMENTAL BIOLOGY = IN VITRO CELL DEV B
IN VITRO CELLULAR & DEVELOPMENTAL BIOLOGY-ANIMAL = IN VITRO CELL DEV-AN
IN VITRO CELLULAR & DEVELOPMENTAL BIOLOGY-PLANT = IN VITRO CELL DEV-PL
IN VITRO TOXICOLOGY = IN VITRO TOXICOL
IN VITRO-JOURNAL OF THE TISSUE CULTURE ASSOCIATION = IN VITRO CELL DEV B
IN VIVO = IN VIVO
INDAGATIONES MATHEMATICAE-NEW SERIES = INDAGAT MATH NEW SER
INDEX ON CENSORSHIP = INDEX CENSORSHIP
INDIAN ECONOMIC AND SOCIAL HISTORY REVIEW = INDIAN ECON SOC HIST
INDIAN HORIZONS = INDIAN HORIZONS
INDIAN JOURNAL OF AGRICULTURAL RESEARCH = INDIAN J AGR RES
INDIAN JOURNAL OF AGRICULTURAL SCIENCES = INDIAN J AGR SCI
INDIAN JOURNAL OF AGRONOMY = INDIAN J AGRON
INDIAN JOURNAL OF ANIMAL SCIENCES = INDIAN J ANIM SCI
INDIAN JOURNAL OF BIOCHEMISTRY & BIOPHYSICS = INDIAN J BIOCHEM BIO
INDIAN JOURNAL OF CHEMICAL TECHNOLOGY = INDIAN J CHEM TECHN
INDIAN JOURNAL OF CHEMISTRY SECTION A-INORGANIC BIO-INORGANIC PHYSICAL THEORETICAL & ANALYTICAL CHEMISTRY = INDIAN J CHEM A
INDIAN JOURNAL OF CHEMISTRY SECTION B-ORGANIC CHEMISTRY INCLUDING MEDICINAL CHEMISTRY = INDIAN J CHEM B
INDIAN JOURNAL OF ENGINEERING AND MATERIALS SCIENCES = INDIAN J ENG MATER S
INDIAN JOURNAL OF EXPERIMENTAL BIOLOGY = INDIAN J EXP BIOL
INDIAN JOURNAL OF FIBRE & TEXTILE RESEARCH = INDIAN J FIBRE TEXT
INDIAN JOURNAL OF GENETICS AND PLANT BREEDING = INDIAN J GENET PL BR
INDIAN JOURNAL OF HETEROCYCLIC CHEMISTRY = INDIAN J HETEROCY CH
INDIAN JOURNAL OF MARINE SCIENCES = INDIAN J MAR SCI
INDIAN JOURNAL OF MEDICAL RESEARCH = INDIAN J MED RES
INDIAN JOURNAL OF MEDICAL RESEARCH SECTION A-INFECTIOUS DISEASES = INDIAN J MED RES-A
INDIAN JOURNAL OF MEDICAL RESEARCH SECTION B-BIOMEDICAL RESEARCH OTHER THAN INFECTIOUS DISEASES = INDIAN J MED RES-B
INDIAN JOURNAL OF PLANT PHYSIOLOGY = INDIAN J PLANT PHYSI
INDIAN JOURNAL OF PURE & APPLIED MATHEMATICS = INDIAN J PURE AP MAT
INDIAN JOURNAL OF PURE & APPLIED PHYSICS = INDIAN J PURE AP PHY
INDIAN JOURNAL OF RADIO & SPACE PHYSICS = INDIAN J RADIO SPACE
INDIAN JOURNAL OF SOCIAL WORK = INDIAN J SOC WORK
INDIAN JOURNAL OF TECHNOLOGY = INDIAN J TECHNOL
INDIAN VETERINARY JOURNAL = INDIAN VET J
INDIANA AGRICULTURAL EXPERIMENT STATION BULLETIN = INDIANA AES BULL
INDIANA AGRICULTURAL EXPERIMENT STATION INSPECTION REPORT = INDIANA AES INSP REP
INDIANA AGRICULTURAL EXPERIMENT STATION RESEARCH BULLETIN = INDIANA AES RES BULL
INDIANA LAW JOURNAL = INDIANA LAW J
INDIANA UNIVERSITY MATHEMATICS JOURNAL = INDIANA U MATH J
INDIVIDUAL PSYCHOLOGY-THE JOURNAL OF ADLERIAN THEORY RESEARCH & PRACTICE = INDIV PSYCHOL
INDO-IRANIAN JOURNAL = INDO-IRAN J
INDOGERMANISCHE FORSCHUNGEN = INDOGER FORSCH
INDOOR AIR-INTERNATIONAL JOURNAL OF INDOOR AIR QUALITY AND CLIMATE = INDOOR AIR
INDOOR AND BUILT ENVIRONMENT = INDOOR BUILT ENVIRON
INDOOR ENVIRONMENT = INDOOR ENVIRON
INDUSTRIA CONSERVE = IND CONSERVE
INDUSTRIAL & ENGINEERING CHEMISTRY FUNDAMENTALS = IND ENG CHEM FUND
INDUSTRIAL & ENGINEERING CHEMISTRY PROCESS DESIGN AND DEVELOPMENT = IND ENG CHEM PROC DD
INDUSTRIAL & ENGINEERING CHEMISTRY PRODUCT RESEARCH AND DEVELOPMENT = IND ENG CHEM PROD RD
INDUSTRIAL & ENGINEERING CHEMISTRY RESEARCH = IND ENG CHEM RES
INDUSTRIAL & LABOR RELATIONS REVIEW = IND LABOR RELAT REV
INDUSTRIAL CERAMICS = IND CERAM
INDUSTRIAL CROPS AND PRODUCTS = IND CROP PROD
INDUSTRIAL DESIGN MAGAZINE = IND DESIGN MAG
INDUSTRIAL DIAMOND REVIEW = IND DIAMOND REV
INDUSTRIAL ENGINEERING = IND ENG
INDUSTRIAL FINISHING = IND FINISH
INDUSTRIAL HEALTH = IND HEALTH
INDUSTRIAL LABORATORY = IND LAB+
INDUSTRIAL LUBRICATION AND TRIBOLOGY = IND LUBR TRIBOL
INDUSTRIAL MANAGEMENT & DATA SYSTEMS = IND MANAGE DATA SYST
INDUSTRIAL MARKETING MANAGEMENT = IND MARKET MANAG
INDUSTRIAL PHOTOGRAPHY = IND PHOTOGR
INDUSTRIAL RELATIONS = IND RELAT
INDUSTRIAL RESEARCH & DEVELOPMENT = RES DEV
INDUSTRIAL ROBOT = IND ROBOT
INDUSTRIAL WASTES = IND WASTE
INDUSTRIE ALIMENTARI = IND ALIMENT-ITALY
INDUSTRY WEEK = IND WEEK
INFANT AND CHILD DEVELOPMENT = INFANT CHILD DEV
INFANT BEHAVIOR & DEVELOPMENT = INFANT BEHAV DEV
INFANT MENTAL HEALTH JOURNAL = INF MENTAL HLTH J
INFANTS AND YOUNG CHILDREN = INFANT YOUNG CHILD
INFECTION = INFECTION
INFECTION AND IMMUNITY = INFECT IMMUN
INFECTION CONTROL AND HOSPITAL EPIDEMIOLOGY = INFECT CONT HOSP EP
INFECTIONS IN MEDICINE = INFECT MED
INFECTIONS IN SURGERY = INFECT SURG
INFECTIONS IN UROLOGY = INFECT UROL
INFECTIOUS AGENTS AND DISEASE-REVIEWS ISSUES AND COMMENTARY = INFECT AGENT DIS
INFECTIOUS DISEASE CLINICS OF NORTH AMERICA = INFECT DIS CLIN N AM
INFECTIOUS DISEASES IN CLINICAL PRACTICE = INFECT DIS CLIN PRAC
INFINI = INFINI
INFINITE DIMENSIONAL ANALYSIS QUANTUM PROBABILITY AND RELATED TOPICS = INFIN DIMENS ANAL QU
INFLAMMATION = INFLAMMATION
INFLAMMATION RESEARCH = INFLAMM RES
INFLAMMATORY BOWEL DISEASES = INFLAMM BOWEL DIS
INFOR = INFOR
INFORMACIJE MIDEM-JOURNAL OF MICROELECTRONICS ELECTRONIC COMPONENTS AND MATERIALS = INFORM MIDEM
INFORMATION & MANAGEMENT = INFORM MANAGE
INFORMATION & RECORDS MANAGEMENT = INFORM REC MANAGE
INFORMATION AGE = INFORM AGE
INFORMATION AND COMPUTATION = INFORM COMPUT
INFORMATION AND CONTROL = INFORM COMPUT
INFORMATION AND CONTROL = INFORM CONTROL
INFORMATION AND DECISION TECHNOLOGIES = INFORM DECIS TECHNOL
INFORMATION AND SOFTWARE TECHNOLOGY = INFORM SOFTWARE TECH
INFORMATION MANAGEMENT = INFORM MANAGE
INFORMATION PROCESSING & MANAGEMENT = INFORM PROCESS MANAG
INFORMATION PROCESSING LETTERS = INFORM PROCESS LETT
INFORMATION RESEARCH AND RESOURCE REPORTS = INFORM RES RESOUR R
INFORMATION SCIENCES = INFORM SCIENCES
INFORMATION SCIENCES-APPLICATIONS = INFORM SCI-APPL
INFORMATION SOCIETY = INFORM SOC
INFORMATION SYSTEMS = INFORM SYST
INFORMATION SYSTEMS JOURNAL = INFORM SYST J
INFORMATION SYSTEMS MANAGEMENT = INFORM SYST MANAGE
INFORMATION SYSTEMS RESEARCH = INFORM SYST RES
INFORMATION TECHNOLOGY AND LIBRARIES = INFORM TECHNOL LIBR
INFORMATION TECHNOLOGY-RESEARCH DEVELOPMENT APPLICATIONS = INFORM TECHNOL R & D
INFORMS JOURNAL ON COMPUTING = INFORMS J COMPUT
INFOSYSTEMS = INFOSYSTEMS
INFRARED PHYSICS = INFRARED PHYS
INFRARED PHYSICS & TECHNOLOGY = INFRARED PHYS TECHN
INFRARED SOLAR PHYSICS = IAU SYMP
INFUSION THERAPY AND TRANSFUSION MEDICINE-INFUSIONSTHERAPIE UND TRANSFUSIONSMEDIZIN = INFUS THER TRANSFUS
INFUSIONSTHERAPIE UND KLINISCHE ERNAHRUNG = INFUS KLIN ERN
INFUSIONSTHERAPIE UND KLINISCHE ERNAHRUNG = INFUSIONSTHERAPIE
INFUSIONSTHERAPIE UND TRANSFUSIONSMEDIZIN = INFUSIONSTHERAPIE
INGENIERIA HIDRAULICA EN MEXICO = ING HIDRAUL MEX
INGENIERIA QUIMICA = ING QUIM
INGENIEUR ARCHIV = ING ARCH
INHALATION TOXICOLOGY = INHAL TOXICOL
INITIAL REPORTS OF THE DEEP SEA DRILLING PROJECT = INITIAL REP DEEP SEA
INJURY-INTERNATIONAL JOURNAL OF THE CARE OF THE INJURED = INJURY
INMUNOLOGIA = INMUNOLOGIA
INNERE MEDIZIN = INN MED
INNOVATION ET TECHNOLOGIE EN BIOLOGIE ET MEDECINE = INNOV TECH BIOL MED
INNOVATIONS IN EDUCATION AND TRAINING INTERNATIONAL = INNOV EDUC TRAIN INT
INORGANIC BIOCHEMISTRY = INORG BIOCHEM
INORGANIC CHEMISTRY = INORG CHEM
INORGANIC CHEMISTRY COMMUNICATIONS = INORG CHEM COMMUN
INORGANIC MATERIALS = INORG MATER+
INORGANIC SYNTHESES = INORG SYN
INORGANICA CHIMICA ACTA = INORG CHIM ACTA
INORGANICA CHIMICA ACTA-ARTICLES = INORG CHIM A-ARTICLE
INORGANICA CHIMICA ACTA-ARTICLES AND LETTERS = INORG CHIM A-ART LET
INORGANICA CHIMICA ACTA-BIOINORGANIC CHEMISTRY = INORG CHIM A-BIOINOR
INORGANICA CHIMICA ACTA-F-BLOCK ELEMENTS ARTICLES AND LETTERS = INORG CHIM A-F-BLOCK
INORGANICA CHIMICA ACTA-LETTERS = INORG CHIM A-LETT
INQUIRY-AN INTERDISCIPLINARY JOURNAL OF PHILOSOPHY = INQUIRY
INQUIRY-THE JOURNAL OF HEALTH CARE ORGANIZATION PROVISION AND FINANCING = INQUIRY-J HEALTH CAR
INSECT BIOCHEMISTRY = INSECT BIOCHEM
INSECT BIOCHEMISTRY AND MOLECULAR BIOLOGY = INSECT BIOCHEM MOLEC
INSECT MOLECULAR BIOLOGY = INSECT MOL BIOL
INSECT SCIENCE AND ITS APPLICATION = INSECT SCI APPL
INSECTES SOCIAUX = INSECT SOC
INSIGHT = INSIGHT
INSTITUTE OF PHYSICS CONFERENCE SERIES = INST PHYS CONF SER
INSTRUCTIONAL SCIENCE = INSTR SCI
INSTRUMENTATION SCIENCE & TECHNOLOGY = INSTRUM SCI TECHNOL
INSTRUMENTATION TECHNOLOGY = INSTR TECHNOL
INSTRUMENTATION TECHNOLOGY = INTECH
INSTRUMENTS & CONTROL SYSTEMS = I&CS-CONTROL TECH EN
INSTRUMENTS AND EXPERIMENTAL TECHNIQUES = INSTRUM EXP TECH+
INSULA-REVISTA DE LETRAS Y CIENCIAS HUMANAS = INSULA
INSURANCE MATHEMATICS & ECONOMICS = INSUR MATH ECON
INTECH = INTECH
INTEGRAL EQUATIONS AND OPERATOR THEORY = INTEGR EQUAT OPER TH
INTEGRAL TRANSFORMS AND SPECIAL FUNCTIONS = INTEGR TRANSF SPEC F
INTEGRATED COMPUTER-AIDED ENGINEERING = INTEGR COMPUT-AID E
INTEGRATED FERROELECTRICS = INTEGR FERROELECTR
INTEGRATION-THE VLSI JOURNAL = INTEGRATION
INTEGRATIVE PHYSIOLOGICAL AND BEHAVIORAL SCIENCE = INTEGR PHYS BEH SCI
INTEGRATIVE PSYCHIATRY = INTEGRATIVE PSYCHIAT
INTELLIGENCE = INTELLIGENCE
INTELLIGENT AUTOMATION AND SOFT COMPUTING = INTELL AUTOM SOFT CO
INTENSIVBEHANDLUNG = INTENSIVBEHANDLUNG
INTENSIVE CARE MEDICINE = INTENS CARE MED
INTERACTING WITH COMPUTERS = INTERACT COMPUT
INTERCHANGE = INTERCHANGE
INTERCIENCIA = INTERCIENCIA
INTERCONNECTION TECHNOLOGY = INTERCONNECT TECHNOL
INTERDISCIPLINARY SCIENCE REVIEWS = INTERDISCIPL SCI REV
INTERFACE AGE = INTERF AGE-COMPUT B
INTERFACE AGE-COMPUTING FOR BUSINESS = INTERF AGE-COMPUT B
INTERFACE SCIENCE = INTERFACE SCI
INTERFACE-JOURNAL OF NEW MUSIC RESEARCH = INTERFACE-J NEW MUS
INTERFACES = INTERFACES
INTERFACES IN COMPUTING = INTERFACE COMPUT
INTERFERON Y BIOTECNOLOGIA = INTERFERON BIOTECNOL
INTERLENDING & DOCUMENT SUPPLY = INTERLEND DOC SUPPLY
INTERMETALLICS = INTERMETALLICS
INTERNAL MEDICINE = INTERNAL MED
INTERNASJONAL POLITIKK = INT POLIT-OSLO
INTERNATIONAL AFFAIRS = INT AFF
INTERNATIONAL AND COMPARATIVE LAW QUARTERLY = INT COMP LAW Q
INTERNATIONAL ANESTHESIOLOGY CLINICS = INT ANESTHESIOL CLIN
INTERNATIONAL ANGIOLOGY = INT ANGIOL
INTERNATIONAL APPLIED MECHANICS = INT APPL MECH+
INTERNATIONAL ARCHIVES OF ALLERGY AND APPLIED IMMUNOLOGY = INT ARCH ALLER A IMM
INTERNATIONAL ARCHIVES OF ALLERGY AND IMMUNOLOGY = INT ARCH ALLERGY IMM
INTERNATIONAL ARCHIVES OF OCCUPATIONAL AND ENVIRONMENTAL HEALTH = INT ARCH OCC ENV HEA
INTERNATIONAL BIODETERIORATION = INT BIODETERIOR
INTERNATIONAL BIODETERIORATION & BIODEGRADATION = INT BIODETER BIODEGR
INTERNATIONAL BIODETERIORATION BULLETIN = INT BIODETERIOR
INTERNATIONAL CAST METALS JOURNAL = INT CAST MET J
INTERNATIONAL CLINICAL PSYCHOPHARMACOLOGY = INT CLIN PSYCHOPHARM
INTERNATIONAL COMMUNICATIONS IN HEAT AND MASS TRANSFER = INT COMMUN HEAT MASS
INTERNATIONAL DAIRY JOURNAL = INT DAIRY J
INTERNATIONAL DENTAL JOURNAL = INT DENT J
INTERNATIONAL ECONOMIC REVIEW = INT ECON REV
INTERNATIONAL ENDODONTIC JOURNAL = INT ENDOD J
INTERNATIONAL ENVIRONMENTAL AFFAIRS = INT ENVIRON AFFAIR
INTERNATIONAL FAMILY PLANNING PERSPECTIVES = INT FAM PLAN PERSPEC
INTERNATIONAL FICTION REVIEW = INT FICTION REV
INTERNATIONAL FORUM ON INFORMATION AND DOCUMENTATION = INT FORUM INFORM DOC
INTERNATIONAL GAS ENGINEERING AND MANAGEMENT = INT GAS ENG MANAGE
INTERNATIONAL GEOLOGY REVIEW = INT GEOL REV
INTERNATIONAL HEPATOLOGY COMMUNICATIONS = INT HEPATOL COMMUN
INTERNATIONAL HISTORY REVIEW = INT HIST REV
INTERNATIONAL HYDROGRAPHIC REVIEW = INT HYDROGR REV
INTERNATIONAL IMMUNOLOGY = INT IMMUNOL
INTERNATIONAL INFORMATION & LIBRARY REVIEW = INT INF LIBR REV
INTERNATIONAL INTERACTIONS = INT INTERACT
INTERNATIONAL JOURNAL = INT J
INTERNATIONAL JOURNAL FOR NUMERICAL AND ANALYTICAL METHODS IN GEOMECHANICS = INT J NUMER ANAL MET
INTERNATIONAL JOURNAL FOR NUMERICAL METHODS IN ENGINEERING = INT J NUMER METH ENG
INTERNATIONAL JOURNAL FOR NUMERICAL METHODS IN FLUIDS = INT J NUMER METH FL
INTERNATIONAL JOURNAL FOR PARASITOLOGY = INT J PARASITOL
INTERNATIONAL JOURNAL FOR PHILOSOPHY OF RELIGION = INT J PHILOS RELIG
INTERNATIONAL JOURNAL FOR QUALITY IN HEALTH CARE = INT J QUAL HEALTH C
INTERNATIONAL JOURNAL FOR THE ADVANCEMENT OF COUNSELLING = INT J ADV COUNS
INTERNATIONAL JOURNAL FOR THE SEMIOTICS OF LAW-REVUE INTERNATIONALE DE SEMIOTIQUE JURIDIQUE = INT J SEMIOTIC LAW
INTERNATIONAL JOURNAL FOR THE STUDY OF ANIMAL PROBLEMS = INT J STUD ANIM PROB
INTERNATIONAL JOURNAL FOR VITAMIN AND NUTRITION RESEARCH = INT J VITAM NUTR RES
INTERNATIONAL JOURNAL OF ADAPTIVE CONTROL AND SIGNAL PROCESSING = INT J ADAPT CONTROL
INTERNATIONAL JOURNAL OF ADHESION AND ADHESIVES = INT J ADHES ADHES
INTERNATIONAL JOURNAL OF ADVANCED MANUFACTURING TECHNOLOGY = INT J ADV MANUF TECH
INTERNATIONAL JOURNAL OF AFRICAN HISTORICAL STUDIES = INT J AFR HIST STUD
INTERNATIONAL JOURNAL OF AGING & HUMAN DEVELOPMENT = INT J AGING HUM DEV
INTERNATIONAL JOURNAL OF ALGEBRA AND COMPUTATION = INT J ALGEBR COMPUT
INTERNATIONAL JOURNAL OF AMERICAN LINGUISTICS = INT J AM LINGUIST
INTERNATIONAL JOURNAL OF ANDROLOGY = INT J ANDROL
INTERNATIONAL JOURNAL OF ANTIMICROBIAL AGENTS = INT J ANTIMICROB AG
INTERNATIONAL JOURNAL OF APPLIED ELECTROMAGNETICS AND MECHANICS = INT J APPL ELECTROM
INTERNATIONAL JOURNAL OF APPLIED RADIATION AND ISOTOPES = INT J APPL RADIAT IS
INTERNATIONAL JOURNAL OF APPROXIMATE REASONING = INT J APPROX REASON
INTERNATIONAL JOURNAL OF ARTIFICIAL ORGANS = INT J ARTIF ORGANS
INTERNATIONAL JOURNAL OF AVIATION PSYCHOLOGY = INT J AVIAT PSYCHOL
INTERNATIONAL JOURNAL OF BEHAVIORAL DEVELOPMENT = INT J BEHAV DEV
INTERNATIONAL JOURNAL OF BEHAVIORAL MEDICINE = INT J BEHAV MED
INTERNATIONAL JOURNAL OF BIFURCATION AND CHAOS = INT J BIFURCAT CHAOS
INTERNATIONAL JOURNAL OF BIO-MEDICAL COMPUTING = INT J BIOMED COMPUT
INTERNATIONAL JOURNAL OF BIOCHEMISTRY = INT J BIOCHEM
INTERNATIONAL JOURNAL OF BIOCHEMISTRY & CELL BIOLOGY = INT J BIOCHEM CELL B
INTERNATIONAL JOURNAL OF BIOLOGICAL MACROMOLECULES = INT J BIOL MACROMOL
INTERNATIONAL JOURNAL OF BIOLOGICAL MARKERS = INT J BIOL MARKER
INTERNATIONAL JOURNAL OF BIOLOGICAL RESEARCH IN PREGNANCY = INT J BIOL RES PREG
INTERNATIONAL JOURNAL OF BIOMETEOROLOGY = INT J BIOMETEOROL
INTERNATIONAL JOURNAL OF CANCER = INT J CANCER
INTERNATIONAL JOURNAL OF CARDIAC IMAGING = INT J CARDIAC IMAG
INTERNATIONAL JOURNAL OF CARDIOLOGY = INT J CARDIOL
INTERNATIONAL JOURNAL OF CAST METALS RESEARCH = INT J CAST METAL RES
INTERNATIONAL JOURNAL OF CELL CLONING = INT J CELL CLONING
INTERNATIONAL JOURNAL OF CHEMICAL KINETICS = INT J CHEM KINET
INTERNATIONAL JOURNAL OF CIRCUIT THEORY AND APPLICATIONS = INT J CIRC THEOR APP
INTERNATIONAL JOURNAL OF CLIMATOLOGY = INT J CLIMATOL
INTERNATIONAL JOURNAL OF CLINICAL & LABORATORY RESEARCH = INT J CLIN LAB RES
INTERNATIONAL JOURNAL OF CLINICAL AND EXPERIMENTAL HYPNOSIS = INT J CLIN EXP HYP
INTERNATIONAL JOURNAL OF CLINICAL MONITORING AND COMPUTING = INT J CLIN MONIT COM
INTERNATIONAL JOURNAL OF CLINICAL NEUROPSYCHOLOGY = INT J CLIN NEUROPSYC
INTERNATIONAL JOURNAL OF CLINICAL PHARMACOLOGY AND THERAPEUTICS = INT J CLIN PHARM TH
INTERNATIONAL JOURNAL OF CLINICAL PHARMACOLOGY RESEARCH = INT J CLIN PHARM RES
INTERNATIONAL JOURNAL OF CLINICAL PRACTICE = INT J CLIN PRACT
INTERNATIONAL JOURNAL OF COAL GEOLOGY = INT J COAL GEOL
INTERNATIONAL JOURNAL OF COLORECTAL DISEASE = INT J COLORECTAL DIS
INTERNATIONAL JOURNAL OF COMMUNICATION SYSTEMS = INT J COMMUN SYST
INTERNATIONAL JOURNAL OF COMPARATIVE SOCIOLOGY = INT J COMP SOCIOL
INTERNATIONAL JOURNAL OF COMPUTATIONAL FLUID DYNAMICS = INT J COMPUT FLUID D
INTERNATIONAL JOURNAL OF COMPUTATIONAL GEOMETRY & APPLICATIONS = INT J COMPUT GEOM AP
INTERNATIONAL JOURNAL OF COMPUTER & INFORMATION SCIENCES = INT J COMPUT INF SCI
INTERNATIONAL JOURNAL OF COMPUTER APPLICATIONS IN TECHNOLOGY = INT J COMPUT APPL T
INTERNATIONAL JOURNAL OF COMPUTER INTEGRATED MANUFACTURING = INT J COMP INTEG M
INTERNATIONAL JOURNAL OF COMPUTER MATHEMATICS = INT J COMPUT MATH
INTERNATIONAL JOURNAL OF COMPUTER VISION = INT J COMPUT VISION
INTERNATIONAL JOURNAL OF CONFLICT MANAGEMENT = INT J CONFL MANAGE
INTERNATIONAL JOURNAL OF CONTROL = INT J CONTROL
INTERNATIONAL JOURNAL OF COOPERATIVE INFORMATION SYSTEMS = INT J COOP INF SYST
INTERNATIONAL JOURNAL OF COSMETIC SCIENCE = INT J COSMETIC SCI
INTERNATIONAL JOURNAL OF DAIRY TECHNOLOGY = INT J DAIRY TECHNOL
INTERNATIONAL JOURNAL OF DAMAGE MECHANICS = INT J DAMAGE MECH
INTERNATIONAL JOURNAL OF DERMATOLOGY = INT J DERMATOL
INTERNATIONAL JOURNAL OF DEVELOPMENTAL BIOLOGY = INT J DEV BIOL
INTERNATIONAL JOURNAL OF DEVELOPMENTAL NEUROSCIENCE = INT J DEV NEUROSCI
INTERNATIONAL JOURNAL OF EARTH SCIENCES = INT J EARTH SCI
INTERNATIONAL JOURNAL OF EATING DISORDERS = INT J EAT DISORDER
INTERNATIONAL JOURNAL OF EDUCATIONAL DEVELOPMENT = INT J EDUC DEV
INTERNATIONAL JOURNAL OF ELECTRICAL ENGINEERING EDUCATION = INT J ELEC ENG EDUC
INTERNATIONAL JOURNAL OF ELECTRICAL POWER & ENERGY SYSTEMS = INT J ELEC POWER
INTERNATIONAL JOURNAL OF ELECTRONIC COMMERCE = INT J ELECTRON COMM
INTERNATIONAL JOURNAL OF ELECTRONICS = INT J ELECTRON
INTERNATIONAL JOURNAL OF ENERGY RESEARCH = INT J ENERG RES
INTERNATIONAL JOURNAL OF ENGINEERING FLUID MECHANICS = INT J ENG FLUID MECH
INTERNATIONAL JOURNAL OF ENGINEERING SCIENCE = INT J ENG SCI
INTERNATIONAL JOURNAL OF ENTOMOLOGY = INT J ENTOMOL
INTERNATIONAL JOURNAL OF ENVIRONMENT AND POLLUTION = INT J ENVIRON POLLUT
INTERNATIONAL JOURNAL OF ENVIRONMENTAL ANALYTICAL CHEMISTRY = INT J ENVIRON AN CH
INTERNATIONAL JOURNAL OF ENVIRONMENTAL HEALTH RESEARCH = INT J ENVIRON HEAL R
INTERNATIONAL JOURNAL OF ENVIRONMENTAL STUDIES = INT J ENVIRON STUD
INTERNATIONAL JOURNAL OF EPIDEMIOLOGY = INT J EPIDEMIOL
INTERNATIONAL JOURNAL OF EXPERIMENTAL PATHOLOGY = INT J EXP PATHOL
INTERNATIONAL JOURNAL OF EXPERT SYSTEMS = INT J EXPERT SYST
INTERNATIONAL JOURNAL OF FATIGUE = INT J FATIGUE
INTERNATIONAL JOURNAL OF FERTILITY = INT J FERTIL
INTERNATIONAL JOURNAL OF FERTILITY AND MENOPAUSAL STUDIES = INT J FERTIL MENOP S
INTERNATIONAL JOURNAL OF FERTILITY AND WOMENS MEDICINE = INT J FERTIL WOMEN M
INTERNATIONAL JOURNAL OF FINANCE & ECONOMICS = INT J FINANC ECON
INTERNATIONAL JOURNAL OF FLEXIBLE MANUFACTURING SYSTEMS = INT J FLEX MANUF SYS
INTERNATIONAL JOURNAL OF FOOD MICROBIOLOGY = INT J FOOD MICROBIOL
INTERNATIONAL JOURNAL OF FOOD SCIENCE AND TECHNOLOGY = INT J FOOD SCI TECH
INTERNATIONAL JOURNAL OF FOOD SCIENCES AND NUTRITION = INT J FOOD SCI NUTR
INTERNATIONAL JOURNAL OF FORECASTING = INT J FORECASTING
INTERNATIONAL JOURNAL OF FRACTURE = INT J FRACTURE
INTERNATIONAL JOURNAL OF GAME THEORY = INT J GAME THEORY
INTERNATIONAL JOURNAL OF GENERAL SYSTEMS = INT J GEN SYST
INTERNATIONAL JOURNAL OF GEOGRAPHICAL INFORMATION SCIENCE = INT J GEOGR INF SCI
INTERNATIONAL JOURNAL OF GEOGRAPHICAL INFORMATION SYSTEMS = INT J GEOGR INF SYST
INTERNATIONAL JOURNAL OF GERIATRIC PSYCHIATRY = INT J GERIATR PSYCH
INTERNATIONAL JOURNAL OF GLOBAL ENERGY ISSUES = INT J GLOBAL ENERGY
INTERNATIONAL JOURNAL OF GROUP PSYCHOTHERAPY = INT J GROUP PSYCHOTH
INTERNATIONAL JOURNAL OF GYNECOLOGICAL CANCER = INT J GYNECOL CANCER
INTERNATIONAL JOURNAL OF GYNECOLOGICAL PATHOLOGY = INT J GYNECOL PATHOL
INTERNATIONAL JOURNAL OF GYNECOLOGY & OBSTETRICS = INT J GYNECOL OBSTET
INTERNATIONAL JOURNAL OF HEALTH PLANNING AND MANAGEMENT = INT J HEALTH PLAN M
INTERNATIONAL JOURNAL OF HEALTH SERVICES = INT J HEALTH SERV
INTERNATIONAL JOURNAL OF HEAT AND FLUID FLOW = INT J HEAT FLUID FL
INTERNATIONAL JOURNAL OF HEAT AND MASS TRANSFER = INT J HEAT MASS TRAN
INTERNATIONAL JOURNAL OF HEMATOLOGY = INT J HEMATOL
INTERNATIONAL JOURNAL OF HIGH PERFORMANCE COMPUTING APPLICATIONS = INT J HIGH PERFORM C
INTERNATIONAL JOURNAL OF HIGH SPEED COMPUTING = INT J HIGH SPEED COM
INTERNATIONAL JOURNAL OF HUMAN FACTORS IN MANUFACTURING = INT J HUM FACTOR MAN
INTERNATIONAL JOURNAL OF HUMAN RESOURCE MANAGEMENT = INT J HUM RESOUR MAN
INTERNATIONAL JOURNAL OF HUMAN-COMPUTER INTERACTION = INT J HUM-COMPUT INT
INTERNATIONAL JOURNAL OF HUMAN-COMPUTER STUDIES = INT J HUM-COMPUT ST
INTERNATIONAL JOURNAL OF HYDROGEN ENERGY = INT J HYDROGEN ENERG
INTERNATIONAL JOURNAL OF HYGIENE AND ENVIRONMENTAL HEALTH = INT J HYG ENVIR HEAL
INTERNATIONAL JOURNAL OF HYPERTHERMIA = INT J HYPERTHER
INTERNATIONAL JOURNAL OF IMAGING SYSTEMS AND TECHNOLOGY = INT J IMAG SYST TECH
INTERNATIONAL JOURNAL OF IMMUNOPATHOLOGY AND PHARMACOLOGY = INT J IMMUNOPATH PH
INTERNATIONAL JOURNAL OF IMMUNOPHARMACOLOGY = INT J IMMUNOPHARMACO
INTERNATIONAL JOURNAL OF IMMUNOTHERAPY = INT J IMMUNOTHER
INTERNATIONAL JOURNAL OF IMPACT ENGINEERING = INT J IMPACT ENG
INTERNATIONAL JOURNAL OF IMPOTENCE RESEARCH = INT J IMPOT RES
INTERNATIONAL JOURNAL OF INDUSTRIAL ENGINEERING-APPLICATIONS AND PRACTICE = INT J IND ENG-APPL P
INTERNATIONAL JOURNAL OF INDUSTRIAL ENGINEERING-THEORY APPLICATIONS AND PRACTICE = INT J IND ENG-THEORY
INTERNATIONAL JOURNAL OF INDUSTRIAL ERGONOMICS = INT J IND ERGONOM
INTERNATIONAL JOURNAL OF INDUSTRIAL ORGANIZATION = INT J IND ORGAN
INTERNATIONAL JOURNAL OF INFORMATION MANAGEMENT = INT J INFORM MANAGE
INTERNATIONAL JOURNAL OF INFRARED AND MILLIMETER WAVES = INT J INFRARED MILLI
INTERNATIONAL JOURNAL OF INORGANIC MATERIALS = INT J INORG MATER
INTERNATIONAL JOURNAL OF INSECT MORPHOLOGY & EMBRYOLOGY = INT J INSECT MORPHOL
INTERNATIONAL JOURNAL OF INTELLIGENT & COOPERATIVE INFORMATION SYSTEMS = INT J INTELL COOP I
INTERNATIONAL JOURNAL OF INTELLIGENT SYSTEMS = INT J INTELL SYST
INTERNATIONAL JOURNAL OF INTERCULTURAL RELATIONS = INT J INTERCULT REL
INTERNATIONAL JOURNAL OF INVERTEBRATE REPRODUCTION = INT J INVER REP DEV
INTERNATIONAL JOURNAL OF INVERTEBRATE REPRODUCTION AND DEVELOPMENT = INT J INVER REP DEV
INTERNATIONAL JOURNAL OF LANGUAGE & COMMUNICATION DISORDERS = INT J LANG COMM DIS
INTERNATIONAL JOURNAL OF LAW AND PSYCHIATRY = INT J LAW PSYCHIAT
INTERNATIONAL JOURNAL OF LEGAL MEDICINE = INT J LEGAL MED
INTERNATIONAL JOURNAL OF LEPROSY = INT J LEPROSY
INTERNATIONAL JOURNAL OF LEPROSY AND OTHER MYCOBACTERIAL DISEASES = INT J LEPROSY
INTERNATIONAL JOURNAL OF MACHINE TOOLS & MANUFACTURE = INT J MACH TOOL MANU
INTERNATIONAL JOURNAL OF MAN-MACHINE STUDIES = INT J MAN MACH STUD
INTERNATIONAL JOURNAL OF MANPOWER = INT J MANPOWER
INTERNATIONAL JOURNAL OF MARKET RESEARCH = INT J MARKET RES
INTERNATIONAL JOURNAL OF MASS SPECTROMETRY = INT J MASS SPECTROM
INTERNATIONAL JOURNAL OF MASS SPECTROMETRY AND ION PROCESSES = INT J MASS SPECTROM
INTERNATIONAL JOURNAL OF MATERIALS & PRODUCT TECHNOLOGY = INT J MATER PROD TEC
INTERNATIONAL JOURNAL OF MATHEMATICS = INT J MATH
INTERNATIONAL JOURNAL OF MECHANICAL SCIENCES = INT J MECH SCI
INTERNATIONAL JOURNAL OF MEDICAL INFORMATICS = INT J MED INFORM
INTERNATIONAL JOURNAL OF MEDICAL MICROBIOLOGY = INT J MED MICROBIOL
INTERNATIONAL JOURNAL OF MENTAL HEALTH = INT J MENT HEALTH
INTERNATIONAL JOURNAL OF METHODS IN PSYCHIATRIC RESEARCH = INT J METHOD PSYCH
INTERNATIONAL JOURNAL OF MICROCIRCULATION-CLINICAL AND EXPERIMENTAL = INT J MICROCIRC
INTERNATIONAL JOURNAL OF MICROGRAPHICS & OPTICAL TECHNOLOGY = INT J MICROGR OPT T
INTERNATIONAL JOURNAL OF MICROWAVE AND MILLIMETER-WAVE COMPUTER-AIDED ENGINEERING = INT J MICROWAVE MILL
INTERNATIONAL JOURNAL OF MIDDLE EAST STUDIES = INT J MIDDLE E STUD
INTERNATIONAL JOURNAL OF MINERAL PROCESSING = INT J MINER PROCESS
INTERNATIONAL JOURNAL OF MINING ENGINEERING = INT J MINING ENG
INTERNATIONAL JOURNAL OF MODERN PHYSICS A = INT J MOD PHYS A
INTERNATIONAL JOURNAL OF MODERN PHYSICS B = INT J MOD PHYS B
INTERNATIONAL JOURNAL OF MODERN PHYSICS C = INT J MOD PHYS C
INTERNATIONAL JOURNAL OF MODERN PHYSICS C-PHYSICS AND COMPUTERS = INT J MOD PHYS C
INTERNATIONAL JOURNAL OF MODERN PHYSICS D = INT J MOD PHYS D
INTERNATIONAL JOURNAL OF MODERN PHYSICS E-NUCLEAR PHYSICS = INT J MOD PHYS E
INTERNATIONAL JOURNAL OF MOLECULAR MEDICINE = INT J MOL MED
INTERNATIONAL JOURNAL OF MULTIPHASE FLOW = INT J MULTIPHAS FLOW
INTERNATIONAL JOURNAL OF NAUTICAL ARCHAEOLOGY = INT J NAUT ARCHAEOL
INTERNATIONAL JOURNAL OF NEURAL SYSTEMS = INT J NEURAL SYST
INTERNATIONAL JOURNAL OF NEUROPSYCHOPHARMACOLOGY = INT J NEUROPSYCHOP
INTERNATIONAL JOURNAL OF NEUROPSYCHOPHARMACOLOGY = INT J NEUROPSYCHOPH
INTERNATIONAL JOURNAL OF NEURORADIOLOGY = INT J NEURORADIOL
INTERNATIONAL JOURNAL OF NEUROSCIENCE = INT J NEUROSCI
INTERNATIONAL JOURNAL OF NON-EQUILIBRIUM PROCESSING = INT J NON-EQUILIB PR
INTERNATIONAL JOURNAL OF NON-LINEAR MECHANICS = INT J NONLINEAR MECH
INTERNATIONAL JOURNAL OF NONLINEAR OPTICAL PHYSICS = INT J NONLINEAR OPT
INTERNATIONAL JOURNAL OF NUCLEAR MEDICINE & BIOLOGY = INT J NUCL MED BIOL
INTERNATIONAL JOURNAL OF NUMERICAL METHODS FOR HEAT & FLUID FLOW = INT J NUMER METHOD H
INTERNATIONAL JOURNAL OF NUMERICAL MODELLING-ELECTRONIC NETWORKS DEVICES AND FIELDS = INT J NUMER MODEL EL
INTERNATIONAL JOURNAL OF NURSING STUDIES = INT J NURS STUD
INTERNATIONAL JOURNAL OF OBESITY = INT J OBESITY
INTERNATIONAL JOURNAL OF OBSTETRIC ANESTHESIA = INT J OBSTET ANESTH
INTERNATIONAL JOURNAL OF OCCUPATIONAL MEDICINE AND TOXICOLOGY = INT J OCCUP MED TOX
INTERNATIONAL JOURNAL OF OCCUPATIONAL MEDICINE IMMUNOLOGY AND TOXICOLOGY = INT J OCCUP MED I T
INTERNATIONAL JOURNAL OF OFFENDER THERAPY AND COMPARATIVE CRIMINOLOGY = INT J OFFENDER THER
INTERNATIONAL JOURNAL OF ONCOLOGY = INT J ONCOL
INTERNATIONAL JOURNAL OF OPERATIONS & PRODUCTION MANAGEMENT = INT J OPER PROD MAN
INTERNATIONAL JOURNAL OF OPTOELECTRONICS = INT J OPTOELECTRON
INTERNATIONAL JOURNAL OF ORAL & MAXILLOFACIAL IMPLANTS = INT J ORAL MAX IMPL
INTERNATIONAL JOURNAL OF ORAL AND MAXILLOFACIAL SURGERY = INT J ORAL MAX SURG
INTERNATIONAL JOURNAL OF ORAL SURGERY = INT J ORAL MAXILLOF
INTERNATIONAL JOURNAL OF OSTEOARCHAEOLOGY = INT J OSTEOARCHAEOL
INTERNATIONAL JOURNAL OF PANCREATOLOGY = INT J PANCREATOL
INTERNATIONAL JOURNAL OF PARALLEL PROGRAMMING = INT J PARALLEL PROG
INTERNATIONAL JOURNAL OF PATTERN RECOGNITION AND ARTIFICIAL INTELLIGENCE = INT J PATTERN RECOGN
INTERNATIONAL JOURNAL OF PEDIATRIC HEMATOLOGY/ONCOLOGY = INT J PEDIAT HEM ONC
INTERNATIONAL JOURNAL OF PEDIATRIC NEPHROLOGY = INT J PED NEPHROL
INTERNATIONAL JOURNAL OF PEDIATRIC OTORHINOLARYNGOLOGY = INT J PEDIATR OTORHI
INTERNATIONAL JOURNAL OF PEPTIDE AND PROTEIN RESEARCH = INT J PEPT PROT RES
INTERNATIONAL JOURNAL OF PERIODONTICS & RESTORATIVE DENTISTRY = INT J PERIODONT REST
INTERNATIONAL JOURNAL OF PEST MANAGEMENT = INT J PEST MANAGE
INTERNATIONAL JOURNAL OF PHARMACEUTICS = INT J PHARM
INTERNATIONAL JOURNAL OF PHARMACOGNOSY = INT J PHARMACOGN
INTERNATIONAL JOURNAL OF PHILOSOPHICAL STUDIES = INT J PHILOS STUD
INTERNATIONAL JOURNAL OF PLANT SCIENCES = INT J PLANT SCI
INTERNATIONAL JOURNAL OF PLASTICITY = INT J PLASTICITY
INTERNATIONAL JOURNAL OF POLYMER ANALYSIS AND CHARACTERIZATION = INT J POLYM ANAL CH
INTERNATIONAL JOURNAL OF POLYMERIC MATERIALS = INT J POLYM MATER
INTERNATIONAL JOURNAL OF POWDER METALLURGY = INT J POWDER METALL
INTERNATIONAL JOURNAL OF PRESSURE VESSELS AND PIPING = INT J PRES VES PIP
INTERNATIONAL JOURNAL OF PRIMATOLOGY = INT J PRIMATOL
INTERNATIONAL JOURNAL OF PRODUCTION ECONOMICS = INT J PROD ECON
INTERNATIONAL JOURNAL OF PRODUCTION RESEARCH = INT J PROD RES
INTERNATIONAL JOURNAL OF PROSTHODONTICS = INT J PROSTHODONT
INTERNATIONAL JOURNAL OF PSYCHIATRY IN MEDICINE = INT J PSYCHIAT MED
INTERNATIONAL JOURNAL OF PSYCHO-ANALYSIS = INT J PSYCHOANAL
INTERNATIONAL JOURNAL OF PSYCHOANALYSIS = INT J PSYCHOANAL
INTERNATIONAL JOURNAL OF PSYCHOLOGY = INT J PSYCHOL
INTERNATIONAL JOURNAL OF PSYCHOPHYSIOLOGY = INT J PSYCHOPHYSIOL
INTERNATIONAL JOURNAL OF PUBLIC OPINION RESEARCH = INT J PUBLIC OPIN R
INTERNATIONAL JOURNAL OF QUANTUM CHEMISTRY = INT J QUANTUM CHEM
INTERNATIONAL JOURNAL OF RADIATION BIOLOGY = INT J RADIAT BIOL
INTERNATIONAL JOURNAL OF RADIATION ONCOLOGY BIOLOGY PHYSICS = INT J RADIAT ONCOL
INTERNATIONAL JOURNAL OF RAPID SOLIDIFICATION = INT J RAPID SOLIDIF
INTERNATIONAL JOURNAL OF REFRACTORY METALS & HARD MATERIALS = INT J REFRACT MET H
INTERNATIONAL JOURNAL OF REFRIGERATION-REVUE INTERNATIONALE DU FROID = INT J REFRIG
INTERNATIONAL JOURNAL OF REHABILITATION RESEARCH = INT J REHABIL RES
INTERNATIONAL JOURNAL OF REMOTE SENSING = INT J REMOTE SENS
INTERNATIONAL JOURNAL OF RESEARCH IN MARKETING = INT J RES MARK
INTERNATIONAL JOURNAL OF RF AND MICROWAVE COMPUTER-AIDED ENGINEERING = INT J RF MICROW C E
INTERNATIONAL JOURNAL OF ROBOTICS & AUTOMATION = INT J ROBOT AUTOM
INTERNATIONAL JOURNAL OF ROBOTICS RESEARCH = INT J ROBOT RES
INTERNATIONAL JOURNAL OF ROBUST AND NONLINEAR CONTROL = INT J ROBUST NONLIN
INTERNATIONAL JOURNAL OF ROCK MECHANICS AND MINING SCIENCES = INT J ROCK MECH MIN
INTERNATIONAL JOURNAL OF ROCK MECHANICS AND MINING SCIENCES & GEOMECHANICS ABSTRACTS = INT J ROCK MECH MIN
INTERNATIONAL JOURNAL OF SATELLITE COMMUNICATIONS = INT J SATELL COMMUN
INTERNATIONAL JOURNAL OF SCIENCE EDUCATION = INT J SCI EDUC
INTERNATIONAL JOURNAL OF SELECTION AND ASSESSMENT = INT J SELECT ASSESS
INTERNATIONAL JOURNAL OF SERVICE INDUSTRY MANAGEMENT = INT J SERV IND MANAG
INTERNATIONAL JOURNAL OF SOCIAL ECONOMICS = INT J SOC ECON
INTERNATIONAL JOURNAL OF SOCIAL PSYCHIATRY = INT J SOC PSYCHIATR
INTERNATIONAL JOURNAL OF SOCIAL WELFARE = INT J SOC WELF
INTERNATIONAL JOURNAL OF SOFTWARE ENGINEERING AND KNOWLEDGE ENGINEERING = INT J SOFTW ENG KNOW
INTERNATIONAL JOURNAL OF SOLIDS AND STRUCTURES = INT J SOLIDS STRUCT
INTERNATIONAL JOURNAL OF SPORT BIOMECHANICS = INT J SPORT BIOMECH
INTERNATIONAL JOURNAL OF SPORT NUTRITION = INT J SPORT NUTR
INTERNATIONAL JOURNAL OF SPORT PSYCHOLOGY = INT J SPORT PSYCHOL
INTERNATIONAL JOURNAL OF SPORTS MEDICINE = INT J SPORTS MED
INTERNATIONAL JOURNAL OF STD & AIDS = INT J STD AIDS
INTERNATIONAL JOURNAL OF STRESS MANAGEMENT = INT J STRESS MANAGE
INTERNATIONAL JOURNAL OF SUPERCOMPUTER APPLICATIONS AND HIGH PERFORMANCE COMPUTING = INT J SUPERCOMPUT AP
INTERNATIONAL JOURNAL OF SURGICAL PATHOLOGY = INT J SURG PATHOL
INTERNATIONAL JOURNAL OF SUSTAINABLE DEVELOPMENT AND WORLD ECOLOGY = INT J SUST DEV WORLD
INTERNATIONAL JOURNAL OF SYSTEMATIC AND EVOLUTIONARY MICROBIOLOGY = INT J SYST EVOL MICR
INTERNATIONAL JOURNAL OF SYSTEMATIC BACTERIOLOGY = INT J SYST BACTERIOL
INTERNATIONAL JOURNAL OF SYSTEMS SCIENCE = INT J SYST SCI
INTERNATIONAL JOURNAL OF TECHNOLOGY ASSESSMENT IN HEALTH CARE = INT J TECHNOL ASSESS
INTERNATIONAL JOURNAL OF TECHNOLOGY MANAGEMENT = INT J TECHNOL MANAGE
INTERNATIONAL JOURNAL OF THE ADDICTIONS = INT J ADDICT
INTERNATIONAL JOURNAL OF THE JAPAN SOCIETY FOR PRECISION ENGINEERING = INT J JPN S PREC ENG
INTERNATIONAL JOURNAL OF THE SOCIOLOGY OF LANGUAGE = INT J SOCIOL LANG
INTERNATIONAL JOURNAL OF THE SOCIOLOGY OF LAW = INT J SOCIOL LAW
INTERNATIONAL JOURNAL OF THEORETICAL PHYSICS = INT J THEOR PHYS
INTERNATIONAL JOURNAL OF THERMAL SCIENCES = INT J THERM SCI
INTERNATIONAL JOURNAL OF THERMOPHYSICS = INT J THERMOPHYS
INTERNATIONAL JOURNAL OF TISSUE REACTIONS-EXPERIMENTAL AND CLINICAL ASPECTS = INT J TISSUE REACT
INTERNATIONAL JOURNAL OF TOXICOLOGY = INT J TOXICOL
INTERNATIONAL JOURNAL OF TROPICAL AGRICULTURE = INT J TROP AGRIC
INTERNATIONAL JOURNAL OF TUBERCULOSIS AND LUNG DISEASE = INT J TUBERC LUNG D
INTERNATIONAL JOURNAL OF TURBO & JET-ENGINES = INT J TURBO JET ENG
INTERNATIONAL JOURNAL OF UNCERTAINTY FUZZINESS AND KNOWLEDGE-BASED SYSTEMS = INT J UNCERTAIN FUZZ
INTERNATIONAL JOURNAL OF URBAN AND REGIONAL RESEARCH = INT J URBAN REGIONAL
INTERNATIONAL JOURNAL OF UROLOGY = INT J UROL
INTERNATIONAL JOURNAL OF VEHICLE DESIGN = INT J VEHICLE DES
INTERNATIONAL JOURNAL OF WILDLAND FIRE = INT J WILDLAND FIRE
INTERNATIONAL JOURNAL OF ZOONOSES = INT J ZOONOSES
INTERNATIONAL JOURNAL ON WORLD PEACE = INT J WORLD PEACE
INTERNATIONAL LABOR AND WORKING-CLASS HISTORY = INT LABOR WORK-CLASS
INTERNATIONAL LABORATORY = INT LAB
INTERNATIONAL LABOUR REVIEW = INT LABOUR REV
INTERNATIONAL MARKETING REVIEW = INT MARKET REV
INTERNATIONAL MATERIALS REVIEWS = INT MATER REV
INTERNATIONAL MATHEMATICS RESEARCH NOTICES = INT MATH RES NOTICES
INTERNATIONAL METALS REVIEWS = INT MATER REV
INTERNATIONAL MIGRATION = INT MIGR
INTERNATIONAL MIGRATION REVIEW = INT MIGR REV
INTERNATIONAL MONETARY FUND STAFF PAPERS = INT MONET FUND S PAP
INTERNATIONAL OPHTHALMOLOGY = INT OPHTHALMOL
INTERNATIONAL OPHTHALMOLOGY CLINICS = INT OPHTHALMOL CLIN
INTERNATIONAL ORGANIZATION = INT ORGAN
INTERNATIONAL ORTHOPAEDICS = INT ORTHOP
INTERNATIONAL PHARMACOPSYCHIATRY = INT PHARMACOPSYCHIAT
INTERNATIONAL PHILOSOPHICAL QUARTERLY = INT PHILOS QUART
INTERNATIONAL POLITICAL SCIENCE REVIEW = INT POLIT SCI REV
INTERNATIONAL POLYMER PROCESSING = INT POLYM PROC
INTERNATIONAL REGIONAL SCIENCE REVIEW = INT REGIONAL SCI REV
INTERNATIONAL REVIEW OF ADMINISTRATIVE SCIENCES = INT REV ADM SCI
INTERNATIONAL REVIEW OF AFRICAN AMERICAN ART = INT REV AFR AM ART
INTERNATIONAL REVIEW OF CONNECTIVE TISSUE RESEARCH = INT REV CONNECT TISS
INTERNATIONAL REVIEW OF CYTOLOGY-A SURVEY OF CELL BIOLOGY = INT REV CYTOL
INTERNATIONAL REVIEW OF EDUCATION = INT REV EDUC
INTERNATIONAL REVIEW OF EXPERIMENTAL PATHOLOGY = INT REV EXP PATHOL
INTERNATIONAL REVIEW OF HYDROBIOLOGY = INT REV HYDROBIOL
INTERNATIONAL REVIEW OF LAW AND ECONOMICS = INT REV LAW ECON
INTERNATIONAL REVIEW OF NEUROBIOLOGY = INT REV NEUROBIOL
INTERNATIONAL REVIEW OF PHYSIOLOGY = INT REV PHYSIOL
INTERNATIONAL REVIEW OF PSYCHIATRY = INT REV PSYCHIATR
INTERNATIONAL REVIEW OF RESEARCH IN MENTAL RETARDATION = INT REV RES MENT RET
INTERNATIONAL REVIEW OF SOCIAL HISTORY = INT REV SOC HIST
INTERNATIONAL REVIEW OF THE AESTHETICS AND SOCIOLOGY OF MUSIC = INT REV AESTHET SOC
INTERNATIONAL REVIEWS IN PHYSICAL CHEMISTRY = INT REV PHYS CHEM
INTERNATIONAL REVIEWS OF ERGONOMICS = INT REV ERGON
INTERNATIONAL SECURITY = INT SECURITY
INTERNATIONAL SOCIAL SCIENCE JOURNAL = INT SOC SCI J
INTERNATIONAL SOCIAL WORK = INT SOC WORK
INTERNATIONAL SOCIOLOGY = INT SOCIOL
INTERNATIONAL STATISTICAL REVIEW = INT STAT REV
INTERNATIONAL STUDIES IN PHILOSOPHY = INT STUD PHILOS
INTERNATIONAL STUDIES QUARTERLY = INT STUD QUART
INTERNATIONAL SUGAR JOURNAL = INT SUGAR J
INTERNATIONAL SURGERY = INT SURG
INTERNATIONAL TAX AND PUBLIC FINANCE = INT TAX PUBLIC FINAN
INTERNATIONAL UROGYNECOLOGY JOURNAL AND PELVIC FLOOR DYSFUNCTION = INT UROGYNECOL J PEL
INTERNATIONAL WILDLIFE = INT WILDLIFE
INTERNATIONAL YEARBOOK OF NEPHROLOGY = INT YEARBOOK NEPHROL
INTERNATIONALE POLITIK = INT POLITIK
INTERNATIONALE REVUE DER GESAMTEN HYDROBIOLOGIE = INT REV GES HYDROBIO
INTERNATIONALES ARCHIV FUR SOZIALGESCHICHTE DER DEUTSCHEN LITERATUR = INT ARCH SOZIALGESCH
INTERNET JOURNAL OF CHEMISTRY = INTERNET J CHEM
INTERNET RESEARCH-ELECTRONIC NETWORKING APPLICATIONS AND POLICY = INTERNET RES
INTERNET WORLD = INTERNET WORLD
INTERNETWORKING-RESEARCH AND EXPERIENCE = INTERNETWORKING
INTERNIST = INTERNIST
INTERPRETATION-A JOURNAL OF BIBLE AND THEOLOGY = INTERPRETATION
INTERPRETATION-A JOURNAL OF POLITICAL PHILOSOPHY = INTERPRETATION-J POL
INTERVENTION IN SCHOOL AND CLINIC = INTERV SCH CLIN
INTERVENTIONAL NEURORADIOLOGY = INTERV NEURORADIOL
INTERVIROLOGY = INTERVIROLOGY
INVASION & METASTASIS = INVAS METAST
INVENTIONES MATHEMATICAE = INVENT MATH
INVERSE PROBLEMS = INVERSE PROBL
INVERSE PROBLEMS IN ENGINEERING = INVERSE PROBL ENG
INVERTEBRATE BIOLOGY = INVERTEBR BIOL
INVERTEBRATE NEUROSCIENCE = INVERTEBR NEUROSCI
INVERTEBRATE REPRODUCTION & DEVELOPMENT = INVERTEBR REPROD DEV
INVERTEBRATE TAXONOMY = INVERTEBR TAXON
INVESTIGACION CLINICA = INVEST CLIN
INVESTIGACION MEDICA INTERNACIONAL = INVEST MED INT
INVESTIGACION PESQUERA = INVEST PESQ
INVESTIGATIONAL NEW DRUGS = INVEST NEW DRUG
INVESTIGATIVE OPHTHALMOLOGY & VISUAL SCIENCE = INVEST OPHTH VIS SCI
INVESTIGATIVE RADIOLOGY = INVEST RADIOL
INZYNIERIA CHEMICZNA I PROCESOWA = INZ CHEM PROCESOWA
ION-SELECTIVE ELECTRODE REVIEWS = ION SEL ELECTRODE R
IOWA AGRICULTURAL AND HOME ECONOMICS EXPERIMENT STATION RESEARCH BULLETIN = IOWA AHEES RES BULL
IOWA AGRICULTURAL AND HOME ECONOMICS EXPERIMENT STATION SPECIAL REPORT = IOWA AHEES SPEC REP
IOWA LAW REVIEW = IOWA LAW REV
IOWA STATE JOURNAL OF RESEARCH = IOWA STATE J RES
IRAL-INTERNATIONAL REVIEW OF APPLIED LINGUISTICS IN LANGUAGE TEACHING = IRAL-INT REV APPL LI
IRANIAN JOURNAL OF CHEMISTRY & CHEMICAL ENGINEERING-INTERNATIONAL ENGLISH EDITION = IRAN J CHEM CHEM ENG
IRANIAN JOURNAL OF SCIENCE AND TECHNOLOGY = IRAN J SCI TECHNOL
IRANIAN POLYMER JOURNAL = IRAN POLYM J
IRCS MEDICAL SCIENCE-BIOCHEMISTRY = IRCS MED SCI-BIOCHEM
IRISH HISTORICAL STUDIES = IRISH HIST STUD
IRISH JOURNAL OF AGRICULTURAL AND FOOD RESEARCH = IRISH J AGR FOOD RES
IRISH JOURNAL OF AGRICULTURAL RESEARCH = IRISH J AGR RES
IRISH JOURNAL OF EARTH SCIENCES = IRISH J EARTH SCI
IRISH JOURNAL OF FOOD SCIENCE AND TECHNOLOGY = IRISH J FOOD SCI TEC
IRISH JOURNAL OF MEDICAL SCIENCE = IRISH J MED SCI
IRISH JOURNAL OF PSYCHOLOGICAL MEDICINE = IRISH J PSYCHOL MED
IRISH JOURNAL OF PSYCHOLOGY = IRISH J PSYCHOL
IRISH MEDICAL JOURNAL = IRISH MED J
IRISH UNIVERSITY REVIEW = IRISH UNIV REV
IRISH VETERINARY JOURNAL = IRISH VET J
IRON AGE = IRON AGE
IRON AND STEEL ENGINEER = IRON STEEL ENG
IRON AND STEEL INTERNATIONAL = IRON STEEL INT
IRONMAKING & STEELMAKING = IRONMAK STEELMAK
IRRIGATION SCIENCE = IRRIGATION SCI
ISA TRANSACTIONS = ISA T
ISI ATLAS OF SCIENCE-ANIMAL & PLANT SCIENCES = ISI ATL SCI-ANIM PL
ISI ATLAS OF SCIENCE-BIOCHEMISTRY = ISI ATLAS-BIOCHEM
ISI ATLAS OF SCIENCE-IMMUNOLOGY = ISI ATLAS-IMMUNOL
ISI ATLAS OF SCIENCE-PHARMACOLOGY = ISI ATLAS-PHARMACOL
ISIJ INTERNATIONAL = ISIJ INT
ISIS = ISIS
ISLA-A JOURNAL OF MICRONESIAN STUDIES = ISLA-J MICRONES STUD
ISLAM-ZEITSCHRIFT FUR GESCHICHTE UND KULTUR DES ISLAMISCHEN ORIENTS = ISLAM
ISLAND ARC = ISL ARC
ISOKINETICS AND EXERCISE SCIENCE = ISOKINET EXERC SCI
ISOTOPE GEOSCIENCE = ISOT GEOSCI
ISOTOPENPRAXIS = ISOTOPENPRAXIS
ISOTOPES IN ENVIRONMENTAL AND HEALTH STUDIES = ISOT ENVIRON HEALT S
ISOZYMES-CURRENT TOPICS IN BIOLOGICAL AND MEDICAL RESEARCH = ISOZYMES-CURR T BIOL
ISPRS JOURNAL OF PHOTOGRAMMETRY AND REMOTE SENSING = ISPRS J PHOTOGRAMM
ISRAEL EXPLORATION JOURNAL = ISRAEL EXPLOR J
ISRAEL JOURNAL OF BOTANY = ISRAEL J BOT
ISRAEL JOURNAL OF CHEMISTRY = ISRAEL J CHEM
ISRAEL JOURNAL OF EARTH SCIENCES = ISRAEL J EARTH SCI
ISRAEL JOURNAL OF MATHEMATICS = ISRAEL J MATH
ISRAEL JOURNAL OF MEDICAL SCIENCES = ISRAEL J MED SCI
ISRAEL JOURNAL OF PLANT SCIENCES = ISRAEL J PLANT SCI
ISRAEL JOURNAL OF PSYCHIATRY AND RELATED SCIENCES = ISRAEL J PSYCHIAT
ISRAEL JOURNAL OF TECHNOLOGY = ISRAEL J TECHNOL
ISRAEL JOURNAL OF ZOOLOGY = ISRAEL J ZOOL
ISRAEL MEDICAL ASSOCIATION JOURNAL = ISRAEL MED ASSOC J
ISRAELI JOURNAL OF AQUACULTURE-BAMIDGEH = ISR J AQUACULT-BAMID
ISSCC DIGEST OF TECHNICAL PAPERS = ISSCC DIG TECH PAP I
ISSUES & STUDIES = ISSUES STUD
ISSUES IN LAW & MEDICINE = ISSUES LAW MED
ISSUES IN SCIENCE AND TECHNOLOGY = ISSUES SCI TECHNOL
ITALIAN JOURNAL OF BIOCHEMISTRY = ITAL J BIOCHEM
ITALIAN JOURNAL OF FOOD SCIENCE = ITAL J FOOD SCI
ITALIAN JOURNAL OF GASTROENTEROLOGY = ITAL J GASTROENTEROL
ITALIAN JOURNAL OF GASTROENTEROLOGY AND HEPATOLOGY = ITAL J GASTROENTEROL
ITALIAN JOURNAL OF MINERAL & ELECTROLYTE METABOLISM = ITAL J MINER ELECT M
ITALIAN JOURNAL OF NEUROLOGICAL SCIENCES = ITAL J NEUROL SCI
ITALIAN JOURNAL OF ZOOLOGY = ITAL J ZOOL
ITE JOURNAL-INSTITUTE OF TRANSPORTATION ENGINEERS = ITE J
ITS JOURNAL = ITS J
IUBMB LIFE = IUBMB LIFE
IUGOSLAVICA PHYSIOLOGICA ET PHARMACOLOGICA ACTA = IUGOSL PHYSL PHARM A
IVHS JOURNAL = IVHS J
IZVESTIYA AKADEMII NAUK AZERBAIDZHANSKOI SSR SERIYA FIZIKO-TEKHNICHESKIKH I MATEMATICHESKIKH NAUK = IZV AN AZERB SSR
IZVESTIYA AKADEMII NAUK FIZIKA ATMOSFERY I OKEANA = IZV AN FIZ ATMOS OK+
IZVESTIYA AKADEMII NAUK SERIYA BIOLOGICHESKAYA = IZV AKAD NAUK BIOL+
IZVESTIYA AKADEMII NAUK SERIYA FIZICHESKAYA = IZV AKAD NAUK FIZ+
IZVESTIYA AKADEMII NAUK SERIYA GEOLOGICHESKAYA = IZV AKAD NAUK GEOL+
IZVESTIYA AKADEMII NAUK SSSR FIZIKA ATMOSFERY I OKEANA = IZV AN SSSR FIZ ATM+
IZVESTIYA AKADEMII NAUK SSSR FIZIKA ZEMLI = IZV AN SSSR FIZ ZEM+
IZVESTIYA AKADEMII NAUK SSSR SERIYA BIOLOGICHESKAYA = IZV AN SSSR BIOL+
IZVESTIYA AKADEMII NAUK SSSR SERIYA FIZICHESKAYA = IZV AN SSSR FIZ+
IZVESTIYA AKADEMII NAUK SSSR SERIYA GEOLOGICHESKAYA = IZV AN SSSR GEOL+
IZVESTIYA MATHEMATICS = IZV MATH+
IZVESTIYA SIBIRSKOGO OTDELENIYA AKADEMII NAUK SSSR SERIYA KHIMICHESKIKH NAUK = IZV SIB OTD AN KHIM+
IZVESTIYA VYSSHIKH UCHEBNYKH ZAVEDENII AVIATSIONAYA TEKHNIKA = IZV VUZ AVIATS TEKH+
IZVESTIYA VYSSHIKH UCHEBNYKH ZAVEDENII FIZIKA = IZV VUZ FIZ+
IZVESTIYA VYSSHIKH UCHEBNYKH ZAVEDENII KHIMIYA I KHIMICHESKAYA TEKHNOLOGIYA = IZV VUZ KHIM KH TEKH
IZVESTIYA VYSSHIKH UCHEBNYKH ZAVEDENII MATEMATIKA = IZV VUZ MAT+
IZVESTIYA VYSSHIKH UCHEBNYKH ZAVEDENII PISHCHEVAYA TEKHNOLOGIYA = IZV VUZ PISHCH TEKH
IZVESTIYA VYSSHIKH UCHEBNYKH ZAVEDENII RADIOELEKTRONIKA = IZV VUZ RADIOELEKTR+
IZVESTIYA VYSSHIKH UCHEBNYKH ZAVEDENII RADIOFIZIKA = IZV VUZ RADIOFIZ+
