LAB ANIMAL = LAB ANIMAL
LABOR HISTORY = LABOR HIST
LABOR LAW JOURNAL = LABOR LAW J
LABORATORNOE DELO = LAB DELO
LABORATORY ANIMAL SCIENCE = LAB ANIM SCI
LABORATORY ANIMALS = LAB ANIM
LABORATORY INVESTIGATION = LAB INVEST
LABORATORY MEDICINE = LAB MED
LABORATORY ROBOTICS AND AUTOMATION = LAB ROBOTICS AUTOMAT
LABOUR-LE TRAVAIL = LABOUR-TRAVAIL
LAIT = LAIT
LANCET = LANCET
LAND DEGRADATION & DEVELOPMENT = LAND DEGRAD DEV
LAND DEGRADATION AND REHABILITATION = LAND DEGRAD REHABIL
LAND ECONOMICS = LAND ECON
LAND USE POLICY = LAND USE POLICY
LANDBAUFORSCHUNG VOLKENRODE = LANDBAUFORSCH VOLK
LANDBOUWTIJDSCHRIFT-REVUE DE L AGRICULTURE = LANDBOUWTIJD-REV AGR
LANDFALL = LANDFALL
LANDSCAPE = LANDSCAPE
LANDSCAPE AND URBAN PLANNING = LANDSCAPE URBAN PLAN
LANDSCAPE ARCHITECTURE = LANDSCAPE ARCHIT
LANDSCAPE ECOLOGY = LANDSCAPE ECOL
LANDSCAPE PLANNING = LANDSCAPE PLAN
LANDTECHNIK = LANDTECHNIK
LANDWIRTSCHAFTLICHE FORSCHUNG = LANDWIRT FORSCH
LANGENBECKS ARCHIV FUR CHIRURGIE = LANGENBECK ARCH CHIR
LANGENBECKS ARCHIVES OF SURGERY = LANGENBECK ARCH SURG
LANGMUIR = LANGMUIR
LANGUAGE = LANGUAGE
LANGUAGE & COMMUNICATION = LANG COMMUN
LANGUAGE AND COGNITIVE PROCESSES = LANG COGNITIVE PROC
LANGUAGE AND SPEECH = LANG SPEECH
LANGUAGE IN SOCIETY = LANG SOC
LANGUAGE LEARNING = LANG LEARN
LANGUAGE SPEECH AND HEARING SERVICES IN SCHOOLS = LANG SPEECH HEAR SER
LANGUE FRANCAISE = LANGUE FRANCAISE
LARGE ANIMAL PRACTICE = LARGE ANIM PRACT
LARGE SCALE SYSTEMS IN INFORMATION AND DECISION TECHNOLOGIES = LARGE SCALE SYST
LARYNGO-RHINO-OTOLOGIE = LARYNGO RHINO OTOL
LARYNGOLOGIE RHINOLOGIE OTOLOGIE VEREINIGT MIT MONATSSCHRIFT FUR OHRENHEILKUNDE = LARYNG RHINOL OTOL V
LARYNGOLOGIE RHINOLOGIE OTOLOGIE VEREINIGT MIT MONATSSCHRIFT FUR OHRENHEILKUNDE = LARYNGO RHINO OTOL
LARYNGOSCOPE = LARYNGOSCOPE
LASER AND PARTICLE BEAMS = LASER PART BEAMS
LASER CHEMISTRY = LASER CHEM
LASER FOCUS WITH FIBEROPTIC TECHNOLOGY = LASER FOCUS WORLD
LASER FOCUS WORLD = LASER FOCUS WORLD
LASER FOCUS-ELECTRO-OPTICS = LAS FOCUS-ELECTRO-OP
LASER FOCUS-ELECTRO-OPTICS = LASER FOCUS WORLD
LASER PHYSICS = LASER PHYS
LASERS IN ENGINEERING = LASER ENG
LASERS IN MEDICAL SCIENCE = LASER MED SCI
LASERS IN SURGERY AND MEDICINE = LASER SURG MED
LATE IMPERIAL CHINA = LATE IMP CHINA
LATIN AMERICAN ANTIQUITY = LAT AM ANTIQ
LATIN AMERICAN APPLIED RESEARCH = LATIN AM APPL RES
LATIN AMERICAN INDIAN LITERATURES JOURNAL = LAT AM INDIAN LIT J
LATIN AMERICAN MUSIC REVIEW-REVISTA DE MUSICA LATINOAMERICANA = LAT AM MUSIC REV
LATIN AMERICAN PERSPECTIVES = LAT AM PERSPECT
LATIN AMERICAN RESEARCH REVIEW = LAT AM RES REV
LATIN AMERICAN THEATRE REVIEW = LAT AM THEATRE REV
LATOMUS = LATOMUS
LATTE = LATTE
LAVAL THEOLOGIQUE ET PHILOSOPHIQUE = LAVAL THEOL PHILOS
LAW & SOCIETY REVIEW = LAW SOC REV
LAW AND CONTEMPORARY PROBLEMS = LAW CONTEMP PROBL
LAW AND HUMAN BEHAVIOR = LAW HUMAN BEHAV
LAW AND PHILOSOPHY = LAW PHILOS
LAW AND SOCIAL INQUIRY-JOURNAL OF THE AMERICAN BAR FOUNDATION = LAW SOCIAL INQUIRY
LAW LIBRARY JOURNAL = LAW LIBR J
LC GC NORTH AMERICA = LC GC N AM
LC GC-MAGAZINE OF SEPARATION SCIENCE = LC GC-MAG SEP SCI
LEADERSHIP QUARTERLY = LEADERSHIP QUART
LEARNED PUBLISHING = LEARN PUBL
LEARNING & MEMORY = LEARN MEMORY
LEARNING AND INDIVIDUAL DIFFERENCES = LEARN INDIVID DIFFER
LEARNING AND INSTRUCTION = LEARN INSTR
LEARNING AND MOTIVATION = LEARN MOTIV
LEARNING DISABILITY QUARTERLY = LEARN DISABILITY Q
LEBENSMITTEL INDUSTRIE = LEBENSMITTELINDUSTR
LEBENSMITTEL-WISSENSCHAFT & TECHNOLOGIE = LEBENSM WISS TECHNOL
LEBENSMITTELINDUSTRIE = LEBENSMITTELINDUSTR
LEBER MAGEN DARM = LEBER MAGEN DARM
LECTURE NOTES IN ARTIFICIAL INTELLIGENCE = LECT NOTES ARTIF INT
LECTURE NOTES IN COMPUTER SCIENCE = LECT NOTES COMPUT SC
LECTURE NOTES IN CONTROL AND INFORMATION SCIENCES = LECT NOTES CONTR INF
LECTURE NOTES IN ECONOMICS AND MATHEMATICAL SYSTEMS = LECT NOTES ECON MATH
LECTURE NOTES IN MATHEMATICS = LECT NOTES MATH
LECTURE NOTES IN PHYSICS = LECT NOTES PHYS
LECTURES ON DATA SECURITY = LECT NOTES COMPUT SC
LECTURES ON PROOF VERIFICATION AND APPROXIMATION ALGORITHMS = LECT NOTES COMPUT SC
LEGACY = LEGACY
LEGISLATIVE STUDIES QUARTERLY = LEGIS STUD QUART
LEISURE SCIENCES = LEISURE SCI
LEONARDO = LEONARDO
LEONARDO MUSIC JOURNAL = LEONARDO MUSIC J
LEPROSY REVIEW = LEPROSY REV
LETHAIA = LETHAIA
LETTERE AL NUOVO CIMENTO = LETT NUOVO CIMENTO
LETTERE ITALIANE = LETT ITAL
LETTERS IN APPLIED MICROBIOLOGY = LETT APPL MICROBIOL
LETTERS IN HEAT AND MASS TRANSFER = LETT HEAT MASS TRANS
LETTERS IN MATHEMATICAL PHYSICS = LETT MATH PHYS
LETTERS IN PEPTIDE SCIENCE = LETT PEPT SCI
LETTRES ROMANES = LETT ROMANES
LEUKEMIA = LEUKEMIA
LEUKEMIA & LYMPHOMA = LEUKEMIA LYMPHOMA
LEUKEMIA RESEARCH = LEUKEMIA RES
LIAS-SOURCES AND DOCUMENTS RELATING TO THE EARLY MODERN HISTORY OF IDEAS = LIAS
LIBERTE = LIBERTE
LIBRARY = LIBRARY
LIBRARY & INFORMATION SCIENCE RESEARCH = LIBR INFORM SCI RES
LIBRARY ACQUISITIONS-PRACTICE AND THEORY = LIBR ACQUIS PRACT TH
LIBRARY AND INFORMATION SCIENCE = LIBR INFORM SCI
LIBRARY CHRONICLE OF THE UNIVERSITY OF TEXAS AT AUSTIN = LIBR CHRON UNIV TEX
LIBRARY COLLECTIONS ACQUISITIONS & TECHNICAL SERVICES = LIBR COLLECT ACQUIS
LIBRARY COMPUTER SYSTEMS AND EQUIPMENT REVIEW = LIBR COMP SYS EQUIP
LIBRARY COMPUTING = LIBR COMPUT
LIBRARY HI TECH = LIBR HI TECH
LIBRARY JOURNAL = LIBR J
LIBRARY QUARTERLY = LIBR QUART
LIBRARY RESOURCES & TECHNICAL SERVICES = LIBR RESOUR TECH SER
LIBRARY SOFTWARE REVIEW = LIBR SOFTWARE REV
LIBRARY TRENDS = LIBR TRENDS
LIBRI = LIBRI
LICHENOLOGIST = LICHENOLOGIST
LIEBIGS ANNALEN = LIEBIGS ANN
LIEBIGS ANNALEN DER CHEMIE = LIEBIGS ANN CHEM
LIEBIGS ANNALEN-RECUEIL = LIEBIGS ANN-RECL
LIFE SCIENCES = LIFE SCI
LIFE SUPPORT SYSTEMS = LIFE SUPPORT SYST
LIFETIME DATA ANALYSIS = LIFETIME DATA ANAL
LIGHT METAL AGE = LIGHT MET AGE
LIGHTING DESIGN & APPLICATION = LIGHT DESIGN APPL
LILI-ZEITSCHRIFT FUR LITERATURWISSENSCHAFT UND LINGUISTIK = LILI
LIMNOLOGY AND OCEANOGRAPHY = LIMNOL OCEANOGR
LINDBERGIA = LINDBERGIA
LINEAR ALGEBRA AND ITS APPLICATIONS = LINEAR ALGEBRA APPL
LINGUA = LINGUA
LINGUA E STILE = LINGUA STILE
LINGUA FRANCA = LINGUA FRANCA
LINGUA NOSTRA = LINGUA NOSTRA
LINGUISTIC INQUIRY = LINGUIST INQ
LINGUISTIC REVIEW = LINGUIST REV
LINGUISTICA BIBLICA = LINGUIST BIBL
LINGUISTICS = LINGUISTICS
LINGUISTICS AND PHILOSOPHY = LINGUIST PHILOS
LINGUISTIQUE = LINGUISTIQUE
LION AND THE UNICORN = LION UNICORN
LIPIDS = LIPIDS
LIQUID CRYSTALS = LIQ CRYST
LISTY CUKROVARNICKE A REPARSKE = LISTY CUKROV
LITERARY REVIEW = LITERARY REV
LITERATUR UND KRITIK = LIT KRITIK
LITERATURE & HISTORY-THIRD SERIES = LIT HIST-THIRD SER
LITERATURE AND MEDICINE = LIT MED
LITERATURE AND PSYCHOLOGY = LIT PSYCHOL
LITERATURE-FILM QUARTERLY = LIT-FILM QUART
LITHIUM = LITHIUM
LITHOS = LITHOS
LITTERATURE = LITTERATURE
LITTERATURES = LITTERATURES
LIVER = LIVER
LIVER TRANSPLANTATION = LIVER TRANSPLANT
LIVER TRANSPLANTATION AND SURGERY = LIVER TRANSPLANT SUR
LIVESTOCK PRODUCTION SCIENCE = LIVEST PROD SCI
LOGISTICS AND TRANSPORTATION REVIEW = LOGIST TRANSPORT REV
LOISIR & SOCIETE-SOCIETY AND LEISURE = LOISIR SOC-SOC LEIS
LONG RANGE PLANNING = LONG RANGE PLANN
LOTUS INTERNATIONAL = LOTUS INT
LOUISIANA AGRICULTURAL EXPERIMENT STATION BULLETIN = LA AES BULL
LOUISIANA AGRICULTURAL EXPERIMENT STATION CIRCULAR = LA AES CIRC
LOUISIANA AGRICULTURE = LA AGR
LOUISIANA LAW REVIEW = LA LAW REV
LOUVAIN MEDICAL = LOUVAIN MED
LOW TEMPERATURE PHYSICS = LOW TEMP PHYS+
LUBRICATION = LUBRICATION
LUBRICATION ENGINEERING = LUBR ENG
LUMINESCENCE = LUMINESCENCE
LUNG = LUNG
LUNG CANCER = LUNG CANCER-J IASLC
LUPUS = LUPUS
LYMPHOKINE AND CYTOKINE RESEARCH = LYMPHOKINE CYTOK RES
LYMPHOKINE RESEARCH = LYMPHOKINE RES
LYMPHOLOGY = LYMPHOLOGY
LYON CHIRURGICAL = LYON CHIR
LYON MEDICAL = LYON MED
