M D COMPUTING = M D COMPUT
M S-MEDECINE SCIENCES = M S-MED SCI
MAATSTAF = MAATSTAF
MACHINE DESIGN = MACH DES
MACHINE LEARNING = MACH LEARN
MACHINE VISION AND APPLICATIONS = MACH VISION APPL
MACHINING SCIENCE AND TECHNOLOGY = MACH SCI TECHNOL
MACROECONOMIC DYNAMICS = MACROECON DYN
MACROMOLECULAR CHEMISTRY AND PHYSICS = MACROMOL CHEM PHYSIC
MACROMOLECULAR MATERIALS AND ENGINEERING = MACROMOL MATER ENG
MACROMOLECULAR RAPID COMMUNICATIONS = MACROMOL RAPID COMM
MACROMOLECULAR SYMPOSIA = MACROMOL SYMP
MACROMOLECULAR THEORY AND SIMULATIONS = MACROMOL THEOR SIMUL
MACROMOLECULES = MACROMOLECULES
MAGAZINE ANTIQUES = MAG ANTIQUES
MAGAZINE OF CONCRETE RESEARCH = MAG CONCRETE RES
MAGNESIUM = MAGNESIUM
MAGNESIUM AND TRACE ELEMENTS = MAGNESIUM TRACE ELEM
MAGNESIUM RESEARCH = MAGNESIUM RES
MAGNESIUM-BULLETIN = MAGNESIUM-B
MAGNETIC RESONANCE IMAGING = MAGN RESON IMAGING
MAGNETIC RESONANCE IN BIOLOGY = MAGNET RESON BIOL
MAGNETIC RESONANCE IN CHEMISTRY = MAGN RESON CHEM
MAGNETIC RESONANCE IN MEDICINE = MAGNET RESON MED
MAGNETIC RESONANCE MATERIALS IN PHYSICS BIOLOGY AND MEDICINE = MAGN RESON MATER PHY
MAGNETIC RESONANCE QUARTERLY = MAGN RESON QUART
MAGYAR ALLATORVOSOK LAPJA = MAGY ALLATORVOSOK
MAGYAR KEMIAI FOLYOIRAT = MAGY KEM FOLY
MAIA-RIVISTA DI LETTERATURE CLASSICHE = MAIA-RIV LETT CLASS
MAIN GROUP CHEMISTRY = MAIN GROUP CHEM
MAIN GROUP METAL CHEMISTRY = MAIN GROUP MET CHEM
MAINE AGRICULTURAL EXPERIMENT STATION BULLETIN = MAINE AES BULL
MAINE AGRICULTURAL EXPERIMENT STATION TECHNICAL BULLETIN = MAINE AES TECH BULL
MAINTENANCE MANAGEMENT INTERNATIONAL = MAINT MANAGE INT
MAKROMOLEKULARE CHEMIE-MACROMOLECULAR CHEMISTRY AND PHYSICS = MAKROMOL CHEM
MAKROMOLEKULARE CHEMIE-MACROMOLECULAR SYMPOSIA = MAKROMOL CHEM-M SYMP
MAKROMOLEKULARE CHEMIE-RAPID COMMUNICATIONS = MAKROMOL CHEM-RAPID
MAKROMOLEKULARE CHEMIE-THEORY AND SIMULATIONS = MAKROMOL CHEM-THEOR
MALACOLOGIA = MALACOLOGIA
MAMMAL REVIEW = MAMMAL REV
MAMMALIA = MAMMALIA
MAMMALIAN GENOME = MAMM GENOME
MAN = MAN
MAN AND WORLD-AN INTERNATIONAL PHILOSOPHICAL REVIEW = MAN WORLD
MAN IN INDIA = MAN INDIA
MANAGEMENT LEARNING = MANAGE LEARN
MANAGEMENT OF WORLD WASTES = MANAGE WORLD WASTE
MANAGEMENT REVIEW = MANAG REV
MANAGEMENT SCIENCE = MANAGE SCI
MANCHESTER SCHOOL = MANCH SCH
MANCHESTER SCHOOL OF ECONOMIC AND SOCIAL STUDIES = MANCH SCH ECON SOC
MANKIND QUARTERLY = MANKIND QUART
MANUAL THERAPY = MANUAL THER
MANUFACTURING CHEMIST = MANUF CHEMIST
MANUFACTURING ENGINEERING = MANUF ENG
MANUSCRIPTA = MANUSCRIPTA
MANUSCRIPTA GEODAETICA = MANUSCR GEODAET
MANUSCRIPTA MATHEMATICA = MANUSCRIPTA MATH
MAPLETECH = MAPLETECH
MARCONI REVIEW = MARCONI REV
MARINE AND FRESHWATER BEHAVIOUR AND PHYSIOLOGY = MAR FRESHW BEHAV PHY
MARINE AND FRESHWATER RESEARCH = MAR FRESHWATER RES
MARINE AND PETROLEUM GEOLOGY = MAR PETROL GEOL
MARINE BEHAVIOUR AND PHYSIOLOGY = MAR BEHAV PHYSIOL
MARINE BIOLOGY = MAR BIOL
MARINE BIOLOGY LETTERS = MAR BIOL LETT
MARINE BIOTECHNOLOGY = MAR BIOTECHNOL
MARINE CHEMISTRY = MAR CHEM
MARINE ECOLOGY-PROGRESS SERIES = MAR ECOL-PROG SER
MARINE ECOLOGY-PUBBLICAZIONI DELLA STAZIONE ZOOLOGICA DI NAPOLI I = MAR ECOL-P S Z N I
MARINE ECOLOGY-PUBBLICAZIONI DELLA STAZIONE ZOOLOGICA DI NAPOLI I = PSZNI MAR ECOL
MARINE ENGINEERING LOG = MAR ENG-LOG
MARINE ENVIRONMENTAL RESEARCH = MAR ENVIRON RES
MARINE FISHERIES REVIEW = MAR FISH REV
MARINE GEODESY = MAR GEOD
MARINE GEOLOGY = MAR GEOL
MARINE GEOPHYSICAL RESEARCHES = MAR GEOPHYS RES
MARINE GEORESOURCES & GEOTECHNOLOGY = MAR GEORESOUR GEOTEC
MARINE GEOTECHNOLOGY = MAR GEOTECHNOL
MARINE MAMMAL SCIENCE = MAR MAMMAL SCI
MARINE MICROPALEONTOLOGY = MAR MICROPALEONTOL
MARINE MINING = MAR MINING
MARINE POLICY = MAR POLICY
MARINE POLLUTION BULLETIN = MAR POLLUT BULL
MARINE TECHNOLOGY AND SNAME NEWS = MAR TECHNOL SNAME N
MARINE TECHNOLOGY SOCIETY JOURNAL = MAR TECHNOL SOC J
MARINERS MIRROR = MARINERS MIRROR
MARK TWAIN JOURNAL = MARK TWAIN J
MARKETING SCIENCE = MARKET SCI
MARRIAGE AND FAMILY REVIEW = MARRIAGE FAM REV
MARYLAND AGRICULTURAL EXPERIMENT STATION BULLETIN = MARYLAND AES BULL
MARYLAND AGRICULTURAL EXPERIMENT STATION MISCELLANEOUS PUBLICATION = MARYLAND AES MISC PU
MARYLAND COOPERATIVE EXTENSION SERVICE BULLETIN = MARYLAND CES BULL
MARYLAND STATE MEDICAL JOURNAL = MARYLAND STATE MED J
MASS SPECTROMETRY REVIEWS = MASS SPECTROM REV
MASS TRANSIT = MASS TRANSIT
MASSACHUSETTS AGRICULTURAL EXPERIMENT STATION RESEARCH BULLETIN = MASS AGR EXP ST RE B
MASSACHUSETTS REVIEW = MASS REV
MASTER DRAWINGS = MASTER DRAWINGS
MATCH-COMMUNICATIONS IN MATHEMATICAL AND IN COMPUTER CHEMISTRY = MATCH-COMMUN MATH CO
MATEKON = MATEKON
MATEMATICA APLICADA E COMPUTACIONAL = MAT APL COMPUT
MATEMATISK-FYSISKE MEDDELELSER KONGELIGE DANSKE VIDENSKABERNES SELSKAB = MAT FYS MEDD DAN VID
MATERIAL HANDLING ENGINEERING = MATER HANDL ENG
MATERIAL UND ORGANISMEN = MATER ORGANISMEN
MATERIALE PLASTICE = MATER PLAST
MATERIALES DE CONSTRUCCION = MATER CONSTRUCC
MATERIALPRUFUNG = MATERIALPRUFUNG
MATERIALS & DESIGN = MATER DESIGN
MATERIALS AND CORROSION-WERKSTOFFE UND KORROSION = MATER CORROS
MATERIALS AND MANUFACTURING PROCESSES = MATER MANUF PROCESS
MATERIALS AND STRUCTURES = MATER STRUCT
MATERIALS AT HIGH TEMPERATURES = MATER HIGH TEMP
MATERIALS CHARACTERIZATION = MATER CHARACT
MATERIALS CHEMISTRY = MATER CHEM
MATERIALS CHEMISTRY AND PHYSICS = MATER CHEM PHYS
MATERIALS ENGINEERING = MATER ENG
MATERIALS EVALUATION = MATER EVAL
MATERIALS FORUM = MATER FORUM
MATERIALS LETTERS = MATER LETT
MATERIALS PERFORMANCE = MATER PERFORMANCE
MATERIALS RESEARCH BULLETIN = MATER RES BULL
MATERIALS RESEARCH INNOVATIONS = MATER RES INNOV
MATERIALS SCIENCE = MATER SCI+
MATERIALS SCIENCE & ENGINEERING C-BIOMIMETIC AND SUPRAMOLECULAR SYSTEMS = MAT SCI ENG C-BIO S
MATERIALS SCIENCE & ENGINEERING C-BIOMIMETIC MATERIALS SENSORS AND SYSTEMS = MAT SCI ENG C-BIOMIM
MATERIALS SCIENCE & ENGINEERING R-REPORTS = MAT SCI ENG R
MATERIALS SCIENCE AND ENGINEERING = MATER SCI ENG
MATERIALS SCIENCE AND ENGINEERING A-STRUCTURAL MATERIALS PROPERTIES MICROSTRUCTURE AND PROCESSING = MAT SCI ENG A-STRUCT
MATERIALS SCIENCE AND ENGINEERING B-SOLID STATE MATERIALS FOR ADVANCED TECHNOLOGY = MAT SCI ENG B-SOLID
MATERIALS SCIENCE AND TECHNOLOGY = MATER SCI TECH SER
MATERIALS SCIENCE APPLICATIONS OF ION BEAM TECHNIQUES = MATER SCI FORUM
MATERIALS SCIENCE FORUM = MATER SCI FORUM
MATERIALS SCIENCE IN SEMICONDUCTOR PROCESSING = MAT SCI SEMICON PROC
MATERIALS SCIENCE REPORTS = MATER SCI REP
MATERIALS SCIENCE RESEARCH INTERNATIONAL = MATER SCI RES INT
MATERIALS TECHNOLOGY = MATER TECHNOL
MATERIALS TRANSACTIONS JIM = MATER T JIM
MATERIALS WORLD = MATER WORLD
MATERIALWISSENSCHAFT UND WERKSTOFFTECHNIK = MATERIALWISS WERKST
MATHEMATICA SCANDINAVICA = MATH SCAND
MATHEMATICAL AND COMPUTER MODELLING = MATH COMPUT MODEL
MATHEMATICAL AND COMPUTER MODELLING OF DYNAMICAL SYSTEMS = MATH COMP MODEL DYN
MATHEMATICAL BIOSCIENCES = MATH BIOSCI
MATHEMATICAL ENGINEERING IN INDUSTRY = MATH ENG IND
MATHEMATICAL FINANCE = MATH FINANC
MATHEMATICAL GAZETTE = MATH GAZ
MATHEMATICAL GEOLOGY = MATH GEOL
MATHEMATICAL INEQUALITIES & APPLICATIONS = MATH INEQUAL APPL
MATHEMATICAL INTELLIGENCER = MATH INTELL
MATHEMATICAL LOGIC QUARTERLY = MATH LOGIC QUART
MATHEMATICAL METHODS IN THE APPLIED SCIENCES = MATH METHOD APPL SCI
MATHEMATICAL METHODS OF OPERATIONS RESEARCH = MATH METHOD OPER RES
MATHEMATICAL MODELLING = MATH MODELLING
MATHEMATICAL MODELS & METHODS IN APPLIED SCIENCES = MATH MOD METH APPL S
MATHEMATICAL NOTES = MATH NOTES+
MATHEMATICAL PROBLEMS IN ENGINEERING = MATH PROBL ENG
MATHEMATICAL PROCEEDINGS OF THE CAMBRIDGE PHILOSOPHICAL SOCIETY = MATH PROC CAMBRIDGE
MATHEMATICAL PROGRAMMING = MATH PROGRAM
MATHEMATICAL PROGRAMMING STUDY = MATH PROGRAM STUD
MATHEMATICAL RESEARCH LETTERS = MATH RES LETT
MATHEMATICAL SOCIAL SCIENCES = MATH SOC SCI
MATHEMATICAL SYSTEMS THEORY = MATH SYST THEORY
MATHEMATICS AND COMPUTERS IN SIMULATION = MATH COMPUT SIMULAT
MATHEMATICS AND MECHANICS OF SOLIDS = MATH MECH SOLIDS
MATHEMATICS MAGAZINE = MATH MAG
MATHEMATICS OF COMPUTATION = MATH COMPUT
MATHEMATICS OF CONTROL SIGNALS AND SYSTEMS = MATH CONTROL SIGNAL
MATHEMATICS OF OPERATIONS RESEARCH = MATH OPER RES
MATHEMATICS OF THE USSR-IZVESTIYA = MATH USSR IZV+
MATHEMATICS OF THE USSR-SBORNIK = MATH USSR SB+
MATHEMATIKA = MATHEMATIKA
MATHEMATISCHE ANNALEN = MATH ANN
MATHEMATISCHE NACHRICHTEN = MATH NACHR
MATHEMATISCHE ZEITSCHRIFT = MATH Z
MATRIX = MATRIX
MATRIX AND TENSOR QUARTERLY = MATRIX TENSOR QUART
MATRIX BIOLOGY = MATRIX BIOL
MATURITAS = MATURITAS
MAYDICA = MAYDICA
MAYO CLINIC PROCEEDINGS = MAYO CLIN PROC
MEANJIN = MEANJIN
MEASUREMENT = MEASUREMENT
MEASUREMENT & CONTROL = MEAS CONTROL-UK
MEASUREMENT AND EVALUATION IN COUNSELING AND DEVELOPMENT = MEAS EVAL COUNS DEV
MEASUREMENT SCIENCE & TECHNOLOGY = MEAS SCI TECHNOL
MEASUREMENT TECHNIQUES = MEAS TECH+
MEASUREMENT TECHNIQUES USSR = MEAS TECH+
MEASUREMENTS & CONTROL = MEAS CONTROL-US
MEAT SCIENCE = MEAT SCI
MECANIQUE INDUSTRIELLE ET MATERIAUX = MEC IND MATER
MECCANICA = MECCANICA
MECHANICAL ENGINEERING = MECH ENG
MECHANICAL SYSTEMS AND SIGNAL PROCESSING = MECH SYST SIGNAL PR
MECHANICS OF COHESIVE-FRICTIONAL MATERIALS = MECH COHES-FRICT MAT
MECHANICS OF COMPOSITE MATERIALS = MECH COMPOS MATER
MECHANICS OF COMPOSITE MATERIALS AND STRUCTURES = MECH COMPOS MATER ST
MECHANICS OF MATERIALS = MECH MATER
MECHANICS OF STRUCTURES AND MACHINES = MECH STRUCT MACH
MECHANICS RESEARCH COMMUNICATIONS = MECH RES COMMUN
MECHANIK MIESIECZNIK NAUKOWO-TECHNICZNY = MECH MIES NAUK TECH
MECHANISM AND MACHINE THEORY = MECH MACH THEORY
MECHANISMS OF AGEING AND DEVELOPMENT = MECH AGEING DEV
MECHANISMS OF DEVELOPMENT = MECH DEVELOP
MECHATRONICS = MECHATRONICS
MEDECINE & CHIRURGIE DIGESTIVES = MED CHIR DIG
MEDECINE ET ARMEES = MED ARMEES
MEDECINE ET MALADIES INFECTIEUSES = MED MALADIES INFECT
MEDECINE NUCLEAIRE = MED NUCL
MEDIA CULTURE & SOCIETY = MEDIA CULT SOC
MEDIA STUDIES JOURNAL = MEDIA STUD J
MEDIATORS OF INFLAMMATION = MEDIAT INFLAMM
MEDICAL & BIOLOGICAL ENGINEERING & COMPUTING = MED BIOL ENG COMPUT
MEDICAL AND PEDIATRIC ONCOLOGY = MED PEDIATR ONCOL
MEDICAL AND VETERINARY ENTOMOLOGY = MED VET ENTOMOL
MEDICAL ANTHROPOLOGY QUARTERLY = MED ANTHROPOL Q
MEDICAL BIOLOGY = MED BIOL
MEDICAL CARE = MED CARE
MEDICAL CARE RESEARCH AND REVIEW = MED CARE RES REV
MEDICAL CLINICS OF NORTH AMERICA = MED CLIN N AM
MEDICAL COLLEGE OF VIRGINIA QUARTERLY = MED COLL VA QUART
MEDICAL DECISION MAKING = MED DECIS MAKING
MEDICAL EDUCATION = MED EDUC
MEDICAL ENGINEERING & PHYSICS = MED ENG PHYS
MEDICAL HISTORY = MED HIST
MEDICAL HYPOTHESES = MED HYPOTHESES
MEDICAL INFORMATICS = MED INFORM
MEDICAL INFORMATICS AND THE INTERNET IN MEDICINE = MED INFORM INTERNET
MEDICAL INSTRUMENTATION = MED INSTRUM
MEDICAL JOURNAL OF AUSTRALIA = MED J AUSTRALIA
MEDICAL LABORATORY SCIENCES = MED LAB SCI
MEDICAL LETTER ON DRUGS AND THERAPEUTICS = MED LETT DRUGS THER
MEDICAL MICROBIOLOGY AND IMMUNOLOGY = MED MICROBIOL IMMUN
MEDICAL MICROBIOLOGY LETTERS = MED MICROBIOL LETT
MEDICAL MYCOLOGY = MED MYCOL
MEDICAL ONCOLOGY = MED ONCOL
MEDICAL ONCOLOGY AND TUMOR PHARMACOTHERAPY = MED ONCOL TUMOR PHAR
MEDICAL PHYSICS = MED PHYS
MEDICAL PRINCIPLES AND PRACTICE = MED PRIN PRACT
MEDICAL PROBLEMS OF PERFORMING ARTISTS = MED PROBL PERFORM AR
MEDICAL PROGRESS THROUGH TECHNOLOGY = MED PROG TECHNOL
MEDICAL SCIENCE RESEARCH = MED SCI RES
MEDICAL SCIENCE RESEARCH-BIOCHEMISTRY = MED SCI RES-BIOCHEM
MEDICAL TEACHER = MED TEACH
MEDICAL TOXICOLOGY AND ADVERSE DRUG EXPERIENCE = MED TOXICOL ADV DRUG
MEDICAL ULTRASOUND = MED ULTRASOUND
MEDICINA CLINICA = MED CLIN-BARCELONA
MEDICINA DELLO SPORT = MED SPORT
MEDICINA ESPANOLA = MED ESP
MEDICINA-BUENOS AIRES = MEDICINA-BUENOS AIRE
MEDICINA-RIVISTA DELLA ENCICLOPEDIA MEDICA ITALIANA = MED-RIV ENC MED ITAL
MEDICINAL CHEMISTRY RESEARCH = MED CHEM RES
MEDICINAL RESEARCH REVIEWS = MED RES REV
MEDICINE = MEDICINE
MEDICINE AND SCIENCE IN SPORTS AND EXERCISE = MED SCI SPORT EXER
MEDICINE SCIENCE AND THE LAW = MED SCI LAW
MEDIOEVO ROMANZO = MEDIOEVO ROMANZO
MEDIUM AEVUM = MEDIUM AEVUM
MEDIZINISCHE KLINIK = MED KLIN
MEDIZINISCHE WELT = MED WELT
MEDSCAPE WOMENS HEALTH = MEDSCAPE WOMENS HEAL
MEDYCYNA WETERYNARYJNA = MED WETER
MEERESFORSCHUNG-REPORTS ON MARINE RESEARCH = MEERESFORSCHUNG
MELANOMA RESEARCH = MELANOMA RES
MELDINGER FRA NORGES LANDBRUKSHOGSKOLE = MELD NORG LANDBRUKS
MELLIAND TEXTILBERICHTE INTERNATIONAL TEXTILE REPORTS = MELLIAND TEXTIL INT
MEMBRANE BIOCHEMISTRY = MEMBRANE BIOCHEM
MEMOIRES ET ETUDES SCIENTIFIQUES DE LA REVUE DE METALLURGIE = MEM ETUD SCI REV MET
MEMOIRS OF THE AMERICAN MATHEMATICAL SOCIETY = MEM AM MATH SOC
MEMOIRS OF THE ENTOMOLOGICAL SOCIETY OF CANADA = MEM ENTOMOL SOC CAN
MEMORIAS DO INSTITUTO OSWALDO CRUZ = MEM I OSWALDO CRUZ
MEMORY = MEMORY
MEMORY & COGNITION = MEM COGNITION
MENDELEEV COMMUNICATIONS = MENDELEEV COMMUN
MENOPAUSE-THE JOURNAL OF THE NORTH AMERICAN MENOPAUSE SOCIETY = MENOPAUSE
MENTAL HANDICAP RESEARCH = MENT HANDICAP RES
MENTAL RETARDATION = MENT RETARD
MENTAL RETARDATION AND DEVELOPMENTAL DISABILITIES RESEARCH REVIEWS = MENT RETARD DEV D R
MER-MARINE ENGINEERS REVIEW = MER-MAR ENG REV
MERKUR-DEUTSCHE ZEITSCHRIFT FUR EUROPAISCHES DENKEN = MERKUR-DEUT Z EUR D
MERRILL-PALMER QUARTERLY-JOURNAL OF DEVELOPMENTAL PSYCHOLOGY = MERRILL PALMER QUART
MESTER = MESTER
META = META
METABOLIC BONE DISEASE & RELATED RESEARCH = METAB BONE DIS RELAT
METABOLIC BRAIN DISEASE = METAB BRAIN DIS
METABOLIC PEDIATRIC AND SYSTEMIC OPHTHALMOLOGY = METAB PEDIATR SYST O
METABOLISM-CLINICAL AND EXPERIMENTAL = METABOLISM
METAL FINISHING = MET FINISH
METAL IONS IN BIOLOGICAL SYSTEMS = MET IONS BIOL SYST
METAL PROGRESS = MET PROG
METAL SCIENCE = MET SCI
METAL SCIENCE AND HEAT TREATMENT = MET SCI HEAT TREAT+
METALL = METALL
METALLOBIOCHEMISTRY, PART C = METHOD ENZYMOL
METALLOBIOCHEMISTRY, PT D = METHOD ENZYMOL
METALLOFIZIKA I NOVEISHIE TEKHNOLOGII = METALLOFIZ NOV TEKH+
METALLOFIZIKA I NOVEISHIE TEKHNOLOGII-METAL PHYSICS AND ADVANCED TECHNOLOGIES = METALLOFIZ NOV TEKH+
METALLOGRAPHY = METALLOGRAPHY
METALLURGIA = METALLURGIA
METALLURGICAL AND MATERIALS TRANSACTIONS A-PHYSICAL METALLURGY AND MATERIALS SCIENCE = METALL MATER TRANS A
METALLURGICAL AND MATERIALS TRANSACTIONS B-PROCESS METALLURGY AND MATERIALS PROCESSING SCIENCE = METALL MATER TRANS B
METALLURGICAL TRANSACTIONS A-PHYSICAL METALLURGY AND MATERIALS SCIENCE = METALL TRANS A
METALLURGICAL TRANSACTIONS B-PROCESS METALLURGY = METALL TRANS B
METALLURGIST = METALLURGIST+
METALS AND MATERIALS-KOREA = MET MATER-KOREA
METALS FORUM = MET FORUM
METALS MATERIALS AND PROCESSES = MET MATER PROCESS
METALS TECHNOLOGY = MET TECHNOL
METALURGIJA = METALURGIJA
METAPHILOSOPHY = METAPHILOSOPHY
METAPHOR AND SYMBOLIC ACTIVITY = METAPHOR SYMB ACT
METASTABLE, MECHANICALLY ALLOYED AND NANOCRYSTALLINE MATERIALS, PTS 1 AND 2 = MATER SCI FORUM
METEORITICS = METEORITICS
METEORITICS & PLANETARY SCIENCE = METEORIT PLANET SCI
METEORITICS & PLANETARY SCIENCE = METORIT PLANET SCI
METEOROLOGICAL APPLICATIONS = METEOROL APPL
METEOROLOGICAL MAGAZINE = METEOROL MAG
METEOROLOGISCHE RUNDSCHAU = METEOROL RUNDSCH
METEOROLOGISCHE ZEITSCHRIFT = METEOROL Z
METEOROLOGY AND ATMOSPHERIC PHYSICS = METEOROL ATMOS PHYS
METHODS AND ASSOCIATED TOOLS FOR THE INFORMATION SYSTEMS LIFE CYCLE = IFIP TRANS A
METHODS AND FINDINGS IN EXPERIMENTAL AND CLINICAL PHARMACOLOGY = METHOD FIND EXP CLIN
METHODS FOR MONITORING AND DIAGNOSING THE EFFICIENCY OF CATALYTIC CONVERTERS: A PATENT-ORIENTED SURVEY = STUD SURF SCI CATAL
METHODS IN CANCER RESEARCH = METHOD CANCER RES
METHODS IN CELL BIOLOGY = METHOD CELL BIOL
METHODS IN ENZYMOLOGY = METHOD ENZYMOL
METHODS IN MICROBIOLOGY = METHOD MICROBIOL
METHODS IN MOLECULAR AND CELLULAR BIOLOGY = METHOD MOL CELL BIOL
METHODS OF BIOCHEMICAL ANALYSIS = METHOD BIOCHEM ANAL
METHODS OF INFORMATION IN MEDICINE = METHOD INFORM MED
METHODS-A COMPANION TO METHODS IN ENZYMOLOGY = METHODS
METRIKA = METRIKA
METROLOGIA = METROLOGIA
METROPOLITAN MUSEUM JOURNAL = METROPOL MUSEUM J
METROPOLITAN MUSEUM OF ART BULLETIN = METROPOL MUS ART B
MEXICAN STUDIES-ESTUDIOS MEXICANOS = MEX STUD
MICHIGAN AGRICULTURAL EXPERIMENT STATION RESEARCH REPORT = MICH AES RES REP
MICHIGAN COOPERATIVE EXTENSION SERVICE EXTENSION BULLETIN = MICH CES EXT BULL
MICHIGAN GERMANIC STUDIES = MICH GERMAN STUD
MICHIGAN HISTORICAL REVIEW = MICH HIST REV
MICHIGAN LAW REVIEW = MICH LAW REV
MICHIGAN MATHEMATICAL JOURNAL = MICH MATH J
MICHIGAN QUARTERLY REVIEW = MICH QUART REV
MICRO = MICRO
MICROBEAM ANALYSIS = MICROBEAM ANAL
MICROBES AND INFECTION = MICROBES INFECT
MICROBIAL DRUG RESISTANCE-MECHANISMS EPIDEMIOLOGY AND DISEASE = MICROB DRUG RESIST
MICROBIAL ECOLOGY = MICROBIAL ECOL
MICROBIAL ECOLOGY IN HEALTH AND DISEASE = MICROB ECOL HEALTH D
MICROBIAL PATHOGENESIS = MICROB PATHOGENESIS
MICROBIOLOGICA = MICROBIOLOGICA
MICROBIOLOGICAL RESEARCH = MICROBIOL RES
MICROBIOLOGICAL REVIEWS = MICROBIOL REV
MICROBIOLOGICAL SCIENCES = MICROBIOL SCI
MICROBIOLOGY = MICROBIOLOGY+
MICROBIOLOGY AND IMMUNOLOGY = MICROBIOL IMMUNOL
MICROBIOLOGY AND MOLECULAR BIOLOGY REVIEWS = MICROBIOL MOL BIOL R
MICROBIOLOGY-UK = MICROBIOL-UK
MICROBIOS = MICROBIOS
MICROCHEMICAL JOURNAL = MICROCHEM J
MICROCIRCULATION = MICROCIRCULATION
MICROCIRCULATION ENDOTHELIUM AND LYMPHATICS = MICROCIRC ENDOTH LYM
MICROCIRCULATION-LONDON = MICROCIRCULATION-LON
MICROCOMPUTING = MICROCOMPUTING
MICROCONTAMINATION = MICROCONTAMINATION
MICROELECTRONIC ENGINEERING = MICROELECTRON ENG
MICROELECTRONICS AND RELIABILITY = MICROELECTRON RELIAB
MICROELECTRONICS JOURNAL = MICROELECTR J
MICROELECTRONICS RELIABILITY = MICROELECTRON RELIAB
MICROGRAVITY SCIENCE AND TECHNOLOGY = MICROGRAVITY SCI TEC
MICRON = MICRON
MICRON AND MICROSCOPICA ACTA = MICRON MICROSC ACTA
MICROPALEONTOLOGY = MICROPALEONTOLOGY
MICROPOROUS AND MESOPOROUS MATERIALS = MICROPOR MESOPOR MAT
MICROPOROUS MATERIALS = MICROPOROUS MATER
MICROPROCESSING AND MICROPROGRAMMING = MICROPROC MICROPROG
MICROPROCESSORS AND MICROSYSTEMS = MICROPROCESS MICROSY
MICROSCALE THERMOPHYSICAL ENGINEERING = MICROSCALE THERM ENG
MICROSCOPE = MICROSCOPE
MICROSCOPIA ELECTRONICA Y BIOLOGIA CELULAR = MICROSC ELECTRON BIO
MICROSCOPICA ACTA = MICROSC ACTA
MICROSCOPY AND MICROANALYSIS = MICROSC MICROANAL
MICROSCOPY MICROANALYSIS MICROSTRUCTURES = MICROSC MICROANAL M
MICROSCOPY RESEARCH AND TECHNIQUE = MICROSC RES TECHNIQ
MICROSURGERY = MICROSURG
MICROSYSTEM TECHNOLOGIES = MICROSYST TECHNOL
MICROTECNIC = MICROTECNIC
MICROVASCULAR RESEARCH = MICROVASC RES
MICROWAVE AND OPTICAL TECHNOLOGY LETTERS = MICROW OPT TECHN LET
MICROWAVE JOURNAL = MICROWAVE J
MICROWAVES = MICROWAVES
MICROWAVES & RF = MICROWAVES RF
MID-AMERICA-AN HISTORICAL REVIEW = MID-AM-HIST REV
MIDDLE EAST JOURNAL = MIDDLE EAST J
MIDDLE EAST POLICY = MIDDLE EAST POLICY
MIDDLE EASTERN STUDIES = MIDDLE EASTERN STUD
MIDWEST QUARTERLY-A JOURNAL OF CONTEMPORARY THOUGHT = MIDWEST QUART
MIDWIFERY = MIDWIFERY
MIKOLOGIYA I FITOPATOLOGIYA = MIKOL FITOPATOL
MIKROCHIMICA ACTA = MIKROCHIM ACTA
MIKROSKOPIE = MIKROSKOPIE
MILBANK QUARTERLY = MILBANK Q
MILCHWISSENSCHAFT-MILK SCIENCE INTERNATIONAL = MILCHWISSENSCHAFT
MILITARGESCHICHTLICHE MITTEILUNGEN = MILITARGESCH MITT
MILITARY LAW REVIEW = MIL LAW REV
MILITARY MEDICINE = MIL MED
MILITARY PSYCHOLOGY = MIL PSYCHOL
MILK INDUSTRY = MILK IND
MILLENNIUM FILM JOURNAL = MILLENNIUM FILM J
MILLENNIUM-JOURNAL OF INTERNATIONAL STUDIES = MILLENNIUM-J INT ST
MILLING = MILLING
MILLING FEED AND FERTILISER = MILL FEED FERTIL
MILTON QUARTERLY = MILTON QUART
MILTON STUDIES = MILTON STUD
MIND = MIND
MIND & LANGUAGE = MIND LANG
MINDS AND MACHINES = MIND MACH
MINERAL AND ELECTROLYTE METABOLISM = MINER ELECTROL METAB
MINERALIUM DEPOSITA = MINER DEPOSITA
MINERALOGICAL MAGAZINE = MINERAL MAG
MINERALOGICAL RECORD = MINERAL REC
MINERALOGY AND PETROLOGY = MINER PETROL
MINERALS & METALLURGICAL PROCESSING = MINER METALL PROC
MINERALS AND METALLURGICAL PROCESSING = MINER METALL PROC
MINERALS AND THE ENVIRONMENT = MINER ENVIRON
MINERALS ENGINEERING = MINER ENG
MINERVA = MINERVA
MINERVA BIOTECNOLOGICA = MINERVA BIOTECNOL
MINERVA CARDIOANGIOLOGICA = MINERVA CARDIOANGIOL
MINERVA MEDICA = MINERVA MED
MINERVA PEDIATRICA = MINERVA PEDIATR
MINI-MICRO SYSTEMS = MINI-MICRO SYST
MINIMALLY INVASIVE NEUROSURGERY = MINIM INVAS NEUROSUR
MINIMALLY INVASIVE THERAPY = MINIMAL INVASIV THER
MINIMALLY INVASIVE THERAPY & ALLIED TECHNOLOGIES = MINIM INVASIV THER
MINING CONGRESS JOURNAL = MIN CONGR J
MINING ENGINEERING = MIN ENG-LITTLETON
MINNESOTA AGRICULTURAL EXPERIMENT STATION BULLETIN = MINN AES BULL
MINNESOTA AGRICULTURAL EXPERIMENT STATION MISCELLANEOUS REPORT = MINN AES MISC REP
MINNESOTA AGRICULTURAL EXPERIMENT STATION TECHNICAL BULLETIN = MINN AES TECH BULL
MINNESOTA AGRICULTURAL EXTENSION SERVICE EXTENSION BULLETIN = MINN AES EXT BULL
MINNESOTA LAW REVIEW = MINN LAW REV
MINNESOTA MEDICINE = MINN MED
MINNESOTA REVIEW = MINN REV
MINNESOTA SYMPOSIA ON CHILD PSYCHOLOGY = MINN SYM CHILD PSYCH
MIRCEN-JOURNAL OF APPLIED MICROBIOLOGY AND BIOTECHNOLOGY = MIRCEN J APPL MICROB
MIS QUARTERLY = MIS QUART
MISSISSIPPI AGRICULTURAL & FORESTRY EXPERIMENT STATION BULLETIN = MISS AFES BULL
MISSISSIPPI AGRICULTURAL & FORESTRY EXPERIMENT STATION INFORMATION SHEET = MISS AFES INFO SHEET
MISSISSIPPI AGRICULTURAL & FORESTRY EXPERIMENT STATION RESEARCH REPORT = MISS AFES RES REP
MISSISSIPPI AGRICULTURAL & FORESTRY EXPERIMENT STATION TECHNICAL BULLETIN = MISS AFES TECH BULL
MISSISSIPPI QUARTERLY = MISS QUART
MISSOURI AGRICULTURAL EXPERIMENT STATION RESEARCH BULLETIN = MO AES RES BULL
MISSOURI MEDICINE = MO MED
MITSUBISHI ELECTRIC ADVANCE = MITSUBISHI ELECTR AD
MITTEILUNGEN DER OSTERREICHISCHEN GEOGRAPHISCHEN GESELLSCHAFT = MITT OSTERR GEOGR G
MITTEILUNGEN DES KUNSTHISTORISCHEN INSTITUTES IN FLORENZ = MITT KUNSTHIST I FLO
MLN-MODERN LANGUAGE NOTES = MLN-MOD LANG NOTES
MNEMOSYNE = MNEMOSYNE
MOBILE NETWORK & APPLICATIONS = MOBILE NETW APPL
MOBILE NETWORKS & APPLICATIONS = MOBILE NETW APPL
MODAL ANALYSIS-THE INTERNATIONAL JOURNAL OF ANALYTICAL AND EXPERIMENTAL MODAL ANALYSIS = MODAL ANAL
MODELING IDENTIFICATION AND CONTROL = MODEL IDENT CONTROL
MODELLING AND SIMULATION IN MATERIALS SCIENCE AND ENGINEERING = MODEL SIMUL MATER SC
MODERN ASIAN STUDIES = MOD ASIAN STUD
MODERN ASPECTS OF ELECTROCHEMISTRY = MOD ASPECT ELECTROC
MODERN AUSTRIAN LITERATURE = MOD AUSTRIAN LIT
MODERN CASTING = MOD CAST
MODERN CHINA = MOD CHINA
MODERN CONCEPTS OF CARDIOVASCULAR DISEASE = MOD CONC CARDIOV DIS
MODERN DRAMA = MOD DRAMA
MODERN FICTION STUDIES = MOD FICTION STUD
MODERN HEBREW LITERATURE = MOD HEBREW LIT
MODERN INTERNATIONAL DRAMA = MOD INT DRAMA
MODERN JUDAISM = MOD JUDAISM
MODERN LANGUAGE JOURNAL = MOD LANG J
MODERN LANGUAGE QUARTERLY = MOD LANG QUART
MODERN LANGUAGE REVIEW = MOD LANG REV
MODERN MACHINE SHOP = MOD MACH SHOP
MODERN MATERIALS HANDLING = MOD MATER HANDL
MODERN METALS = MOD MET
MODERN PAINT AND COATINGS = MOD PAINT COATING
MODERN PATHOLOGY = MODERN PATHOL
MODERN PHILOLOGY = MOD PHILOLOGY
MODERN PHYSICS LETTERS A = MOD PHYS LETT A
MODERN PHYSICS LETTERS B = MOD PHYS LETT B
MODERN PLASTICS = MOD PLAST
MODERN PROBLEMS OF PHARMACOPSYCHIATRY = MOD PROBL PHARM
MODERN SCHOOLMAN = MOD SCHOOLMAN
MODERN VETERINARY PRACTICE = MOD VET PRACT
MODERNA SPRAK = MOD SPRAK
MODERNISM-MODERNITY = MODERNISM-MODERNITY
MOKUZAI GAKKAISHI = MOKUZAI GAKKAISHI
MOLDING SYSTEMS = MOLDING SYST
MOLECULAR & GENERAL GENETICS = MOL GEN GENET
MOLECULAR AND BIOCHEMICAL PARASITOLOGY = MOL BIOCHEM PARASIT
MOLECULAR AND CELLULAR BIOCHEMISTRY = MOL CELL BIOCHEM
MOLECULAR AND CELLULAR BIOLOGY = MOL CELL BIOL
MOLECULAR AND CELLULAR DIFFERENTIATION = MOL CELL DIFFER
MOLECULAR AND CELLULAR ENDOCRINOLOGY = MOL CELL ENDOCRINOL
MOLECULAR AND CELLULAR NEUROSCIENCE = MOL CELL NEUROSCI
MOLECULAR AND CELLULAR PROBES = MOL CELL PROBE
MOLECULAR AND CHEMICAL NEUROPATHOLOGY = MOL CHEM NEUROPATHOL
MOLECULAR AND GENERAL GENETICS = MOL GEN GENET
MOLECULAR ASPECTS OF MEDICINE = MOL ASPECTS MED
MOLECULAR BIOLOGY = MOL BIOL+
MOLECULAR BIOLOGY & MEDICINE = MOL BIOL MED
MOLECULAR BIOLOGY AND EVOLUTION = MOL BIOL EVOL
MOLECULAR BIOLOGY OF THE CELL = MOL BIOL CELL
MOLECULAR BIOLOGY REPORTS = MOL BIOL REP
MOLECULAR BIOTECHNOLOGY = MOL BIOTECHNOL
MOLECULAR BIOTHERAPY = MOL BIOTHER
MOLECULAR BRAIN RESEARCH = MOL BRAIN RES
MOLECULAR BREEDING = MOL BREEDING
MOLECULAR CARCINOGENESIS = MOL CARCINOGEN
MOLECULAR CELL = MOL CELL
MOLECULAR CHAPERONES = METHOD ENZYMOL
MOLECULAR CRYSTALS AND LIQUID CRYSTALS = MOL CRYST LIQ CRYST
MOLECULAR CRYSTALS AND LIQUID CRYSTALS SCIENCE AND TECHNOLOGY SECTION A-MOLECULAR CRYSTALS AND LIQUID CRYSTALS = MOL CRYST LIQ CRYS A
MOLECULAR CRYSTALS AND LIQUID CRYSTALS SCIENCE AND TECHNOLOGY SECTION C-MOLECULAR MATERIALS = MOL CRYST LIQ CRYS C
MOLECULAR DIAGNOSIS = MOL DIAGN
MOLECULAR DIVERSITY = MOL DIVERS
MOLECULAR ECOLOGY = MOL ECOL
MOLECULAR ENDOCRINOLOGY = MOL ENDOCRINOL
MOLECULAR GENETICS AND METABOLISM = MOL GENET METAB
MOLECULAR HUMAN REPRODUCTION = MOL HUM REPROD
MOLECULAR IMMUNOLOGY = MOL IMMUNOL
MOLECULAR MARINE BIOLOGY AND BIOTECHNOLOGY = MOL MAR BIOL BIOTECH
MOLECULAR MEDICINE = MOL MED
MOLECULAR MEDICINE TODAY = MOL MED TODAY
MOLECULAR MEMBRANE BIOLOGY = MOL MEMBR BIOL
MOLECULAR MICROBIOLOGY = MOL MICROBIOL
MOLECULAR NEUROBIOLOGY = MOL NEUROBIOL
MOLECULAR PHARMACOLOGY = MOL PHARMACOL
MOLECULAR PHYLOGENETICS AND EVOLUTION = MOL PHYLOGENET EVOL
MOLECULAR PHYSICS = MOL PHYS
MOLECULAR PHYSIOLOGY = MOL PHYSIOL
MOLECULAR PLANT-MICROBE INTERACTIONS = MOL PLANT MICROBE IN
MOLECULAR PSYCHIATRY = MOL PSYCHIATR
MOLECULAR REPRODUCTION AND DEVELOPMENT = MOL REPROD DEV
MOLECULAR SIMULATION = MOL SIMULAT
MOLECULAR UROLOGY = MOL UROL
MOLECULAR VISION = MOL VIS
MOLECULES = MOLECULES
MOLECULES AND CELLS = MOL CELLS
MONATSHEFTE FUR CHEMIE = MONATSH CHEM
MONATSHEFTE FUR MATHEMATIK = MONATSH MATH
MONATSHEFTE FUR VETERINARMEDIZIN = MONATSH VETERINARMED
MONATSSCHRIFT FUR BRAUEREI = MONAT BRAUEREI
MONATSSCHRIFT FUR BRAUWISSENSCHAFT = MONATSSCHR BRAUWISS
MONATSSCHRIFT KINDERHEILKUNDE = MONATSSCHR KINDERH
MONIST = MONIST
MONITORE ZOOLOGICO ITALIANO-ITALIAN JOURNAL OF ZOOLOGY = MONIT ZOOL ITAL
MONOGRAPHS IN ALLERGY = MONOGR ALLERGY
MONOGRAPHS IN CLINICAL CYTOLOGY = MG CLIN CYT
MONOGRAPHS IN PAEDIATRICS = MONOGR PAEDIATR
MONOGRAPHS OF THE SOCIETY FOR RESEARCH IN CHILD DEVELOPMENT = MONOGR SOC RES CHILD
MONTANA AGRICULTURAL EXPERIMENT STATION BULLETIN = MONT AES BULL
MONTANA-THE MAGAZINE OF WESTERN HISTORY = MONTANA
MONTHLY LABOR REVIEW = MON LABOR REV
MONTHLY NOTICES OF THE ROYAL ASTRONOMICAL SOCIETY = MON NOT R ASTRON SOC
MONTHLY REVIEW-AN INDEPENDENT SOCIALIST MAGAZINE = MON REV
MONTHLY WEATHER REVIEW = MON WEATHER REV
MONUMENTA NIPPONICA = MONUM NIPPON
MONUMENTS HISTORIQUES = MONUMENT HIST
MOON AND THE PLANETS = MOON PLANETS
MOREANA = MOREANA
MORFOLOGIA NORMAL Y PATOLOGICA SECCION A-HISTOLOGIA = MORFOL NORM PATOL A
MORFOLOGIA NORMAL Y PATOLOGICA SECCION B-ANATOMIA PATOLOGICA = MORFOL NORM PATOL B
MOSAIC-A JOURNAL FOR THE INTERDISCIPLINARY STUDY OF LITERATURE = MOSAIC
MOSQUITO NEWS = MOSQ NEWS
MOTIVATION AND EMOTION = MOTIV EMOTION
MOTOR CONTROL = MOTOR CONTROL
MOUNT SINAI JOURNAL OF MEDICINE = MT SINAI J MED
MOUNTAIN RESEARCH AND DEVELOPMENT = MT RES DEV
MOUVEMENT SOCIAL = MOUVEMENT SOC
MOVEMENT DISORDERS = MOVEMENT DISORD
MOYEN AGE = MOYEN AGE
MRS BULLETIN = MRS BULL
MRS INTERNET JOURNAL OF NITRIDE SEMICONDUCTOR RESEARCH = MRS INTERNET J N S R
MULTIBODY SYSTEM DYNAMICS = MULTIBODY SYST DYN
MULTIDIMENSIONAL SYSTEMS AND SIGNAL PROCESSING = MULTIDIM SYST SIGN P
MULTIMEDIA SYSTEMS = MULTIMEDIA SYST
MULTIMEDIA TOOLS AND APPLICATIONS = MULTIMED TOOLS APPL
MULTINATIONAL MONITOR = MULTINATL MONIT
MULTIPLE SCLEROSIS = MULT SCLER
MULTIVARIATE BEHAVIORAL RESEARCH = MULTIVAR BEHAV RES
MUNCHENER MEDIZINISCHE WOCHENSCHRIFT = MUNCHEN MED WOCHEN
MUSCLE & NERVE = MUSCLE NERVE
MUSEUM INTERNATIONAL = MUSEUM INT
MUSEUM NEWS = MUSEUM NEWS
MUSIC & LETTERS = MUSIC LETT
MUSIC ANALYSIS = MUSIC ANAL
MUSIC PERCEPTION = MUSIC PERCEPT
MUSIC THEORY SPECTRUM = MUSIC THEOR SPECTRUM
MUSICA = MUSICA
MUSICAL QUARTERLY = MUSIC QUART
MUSICAL TIMES = MUSIC TIMES
MUSIK IN BAYERN = MUSIK BAYERN
MUSIK UND KIRCHE = MUSIK KIRCHE
MUSIKFORSCHUNG = MUSIKFORSCHUNG
MUSIKTHEORIE = MUSIKTHEORIE
MUSLIM WORLD = MUSLIM WORLD
MUTAGENESIS = MUTAGENESIS
MUTATION RESEARCH = MUTAT RES
MUTATION RESEARCH LETTERS = MUTAT RES LETT
MUTATION RESEARCH-DNA REPAIR = MUTAT RES-DNA REPAIR
MUTATION RESEARCH-DNAGING GENETIC INSTABILITY AND AGING = MUTAT RES-DNAGING G
MUTATION RESEARCH-ENVIRONMENTAL MUTAGENESIS AND RELATED SUBJECTS = MUTAT RES-ENVIR MUTA
MUTATION RESEARCH-FUNDAMENTAL AND MOLECULAR MECHANISMS OF MUTAGENESIS = MUTAT RES-FUND MOL M
MUTATION RESEARCH-GENETIC TOXICOLOGY = MUTAT RES-GENET TOX
MUTATION RESEARCH-GENETIC TOXICOLOGY AND ENVIRONMENTAL MUTAGENESIS = MUTAT RES-GEN TOX EN
MUTATION RESEARCH-GENOMICS = MUTAT RES-GENOMICS
MUTATION RESEARCH-REVIEWS IN GENETIC TOXICOLOGY = MUTAT RES-REV GENET
MUTATION RESEARCH-REVIEWS IN MUTATION RESEARCH = MUTAT RES-REV MUTAT
MUTTERSPRACHE = MUTTERSPRACHE
MYCOLOGIA = MYCOLOGIA
MYCOLOGICAL RESEARCH = MYCOL RES
MYCOPATHOLOGIA = MYCOPATHOLOGIA
MYCORRHIZA = MYCORRHIZA
MYCOSES = MYCOSES
MYCOTAXON = MYCOTAXON
MYKOSEN = MYCOSES
MYKOSEN = MYKOSEN
MYSORE JOURNAL OF AGRICULTURAL SCIENCES = MYSORE J AGR SCI
