R & D MANAGEMENT = R&D MANAGE
R&D MAGAZINE = R&D MAG
RACAR-REVUE D ART CANADIENNE-CANADIAN ART REVIEW = RACAR
RACE & CLASS = RACE CLASS
RADIATION AND ENVIRONMENTAL BIOPHYSICS = RADIAT ENVIRON BIOPH
RADIATION EFFECTS AND DEFECTS IN SOLIDS = RADIAT EFF DEFECT S
RADIATION EFFECTS LETTERS = RADIAT EFF LETT
RADIATION MEASUREMENTS = RADIAT MEAS
RADIATION ONCOLOGY INVESTIGATIONS = RADIAT ONCOL INVESTI
RADIATION PHYSICS AND CHEMISTRY = RADIAT PHYS CHEM
RADIATION PROTECTION DOSIMETRY = RADIAT PROT DOSIM
RADIATION RESEARCH = RADIAT RES
RADICAL HISTORY REVIEW = RADICAL HIST REV
RADICAL PHILOSOPHY = RADICAL PHILOS
RADIO AND ELECTRONIC ENGINEER = J I ELECTRON RAD ENG
RADIO SCIENCE = RADIO SCI
RADIO-ELECTRONICS = RADIO-ELECTRON
RADIOACTIVE WASTE MANAGEMENT AND ENVIRONMENTAL RESTORATION = RADIOACT WASTE MANAG
RADIOCARBON = RADIOCARBON
RADIOCHEMICAL AND RADIOANALYTICAL LETTERS = RADIOCHEM RADIOA LET
RADIOCHEMISTRY = RADIOCHEMISTRY+
RADIOCHIMICA ACTA = RADIOCHIM ACTA
RADIOGRAPHICS = RADIOGRAPHICS
RADIOLOGE = RADIOLOGE
RADIOLOGIA = RADIOLOGIA-MADRID
RADIOLOGIC CLINICS OF NORTH AMERICA = RADIOL CLIN N AM
RADIOLOGY = RADIOLOGY
RADIOPROTECTION = RADIOPROTECTION
RADIOTEKHNIKA I ELEKTRONIKA = RADIOTEKH ELEKTRON+
RADIOTHERAPY AND ONCOLOGY = RADIOTHER ONCOL
RAFFLES BULLETIN OF ZOOLOGY = RAFFLES B ZOOL
RAIRO-ANALYSE NUMERIQUE-NUMERICAL ANALYSIS = RAIRO-ANAL NUMER-NUM
RAIRO-AUTOMATIQUE-PRODUCTIQUE INFORMATIQUE INDUSTRIELLE-AUTOMATIC CONTROL PRODUCTION SYSTEMS = RAIRO-AUTOM PROD INF
RAIRO-AUTOMATIQUE-SYSTEMS ANALYSIS AND CONTROL = RAIRO-AUTOM-SYST ANA
RAIRO-INFORMATIQUE THEORIQUE ET APPLICATIONS-THEORETICAL INFORMATICS AND APPLICATIONS = RAIRO-INF THEOR APPL
RAIRO-INFORMATIQUE-COMPUTER SCIENCE = RAIRO-INF-COMPUT SCI
RAIRO-MATHEMATICAL MODELLING AND NUMERICAL ANALYSIS-MODELISATION MATHEMATIQUE ET ANALYSE NUMERIQUE = RAIRO-MATH MODEL NUM
RAIRO-RECHERCHE OPERATIONNELLE-OPERATIONS RESEARCH = RAIRO-RECH OPER
RAMANUJAN JOURNAL = RAMANUJAN J
RAMUS-CRITICAL STUDIES IN GREEK AND ROMAN LITERATURE = RAMUS
RAND JOURNAL OF ECONOMICS = RAND J ECON
RANDOM STRUCTURES & ALGORITHMS = RANDOM STRUCT ALGOR
RANGELAND JOURNAL = RANGELAND J
RAPID COMMUNICATIONS IN MASS SPECTROMETRY = RAPID COMMUN MASS SP
RARE METAL MATERIALS AND ENGINEERING = RARE METAL MAT ENG
RARE METALS = RARE METALS
RARITAN-A QUARTERLY REVIEW = RARITAN
RASSEGNA DELLA LETTERATURA ITALIANA = RASS LETT ITAL
RASSEGNA STORICA DEL RISORGIMENTO = RASS STOR RISORGIMEN
RATIO-NEW SERIES = RATIO
RATIONALITY AND SOCIETY = RATION SOC
RBC-CELL BIOLOGY REVIEWS = RBC-CELL BIOL REV
RCA REVIEW = RCA REV
REACTION KINETICS AND CATALYSIS LETTERS = REACT KINET CATAL L
REACTIVE & FUNCTIONAL POLYMERS = REACT FUNCT POLYM
REACTIVE POLYMERS = REACT POLYM
REACTIVITY OF SOLIDS = REACT SOLID
READING AND WRITING = READ WRIT
READING RESEARCH AND INSTRUCTION = READ RES INSTRUCT
READING RESEARCH QUARTERLY = READ RES QUART
READING TEACHER = READ TEACH
REAL ESTATE ECONOMICS = REAL ESTATE ECON
REAL ESTATE REVIEW = REAL ESTATE REV
REAL-TIME IMAGING = REAL-TIME IMAGING
REAL-TIME SYSTEMS = REAL-TIME SYST
RECENT ADVANCES IN PHYTOCHEMISTRY = RECENT ADV PHYTOCHEM
RECENT PROGRESS IN HORMONE RESEARCH = RECENT PROG HORM RES
RECENT RESULTS IN CANCER RESEARCH = RECENT RES CANCER
RECEPTOR = RECEPTOR
RECEPTORS & CHANNELS = RECEPTOR CHANNEL
RECEPTORS & SIGNAL TRANSDUCTION = RECEPT SIGNAL TRANS
RECEPTORS AND RECOGNITION SERIES B = RECEPTOR RECOG SER B
RECHERCHE = RECHERCHE
RECHERCHE AEROSPATIALE = RECH AEROSPATIALE
RECLAMATION & REVEGETATION RESEARCH = RECLAM REVEG RES
RECORD-AT&T BELL LABORATORIES = RECORD-AT&T BELL LAB
RECUEIL DE MEDECINE VETERINAIRE = RECL MED VET
RECUEIL DES TRAVAUX CHIMIQUES DES PAYS-BAS-JOURNAL OF THE ROYAL NETHERLANDS CHEMICAL SOCIETY = RECL TRAV CHIM PAY B
REDOX REPORT = REDOX REP
REFERENCE & USER SERVICES QUARTERLY = REF USER SERV Q
REFRACTIVE AND CORNEAL SURGERY = REFRACT CORNEAL SURG
REFRACTORIES = REFRACTORIES-USSR+
REFRACTORIES AND INDUSTRIAL CERAMICS = REFRACT IND CERAM+
REFRACTORIES JOURNAL = REFRACT J
REGIONAL ANESTHESIA = REGION ANESTH
REGIONAL ANESTHESIA AND PAIN MEDICINE = REGION ANESTH PAIN M
REGIONAL SCIENCE AND URBAN ECONOMICS = REG SCI URBAN ECON
REGIONAL STUDIES = REG STUD
REGULATED RIVERS-RESEARCH & MANAGEMENT = REGUL RIVER
REGULATORY PEPTIDES = REGUL PEPTIDES
REGULATORY TOXICOLOGY AND PHARMACOLOGY = REGUL TOXICOL PHARM
REHABILITATION COUNSELING BULLETIN = REHABIL COUNS BULL
REHABILITATION PSYCHOLOGY = REHABIL PSYCHOL
RELATIONS INDUSTRIELLES-INDUSTRIAL RELATIONS = RELAT IND-IND RELAT
RELIABILITY ENGINEERING & SYSTEM SAFETY = RELIAB ENG SYST SAFE
RELIGION = RELIGION
RELIGION & LITERATURE = RELIG LIT
RELIGION AND AMERICAN CULTURE-A JOURNAL OF INTERPRETATION = RELIG AM CULT
RELIGIOUS EDUCATION = RELIG EDUC
RELIGIOUS HUMANISM = RELIG HUMANISM
RELIGIOUS STUDIES = RELIG STUD
REMEDIAL AND SPECIAL EDUCATION = REM SPEC EDUC
REMOTE SENSING OF ENVIRONMENT = REMOTE SENS ENVIRON
RENAISSANCE AND REFORMATION = RENAISSANCE REFORM
RENAISSANCE QUARTERLY = RENAISSANCE QUART
RENAL FAILURE = RENAL FAILURE
RENAL PHYSIOLOGY AND BIOCHEMISTRY = RENAL PHYSIOL BIOCH
RENASCENCE-ESSAYS ON VALUES IN LITERATURE = RENASCENCE
RENEWABLE & SUSTAINABLE ENERGY REVIEWS = RENEW SUST ENERG REV
RENEWABLE ENERGY = RENEW ENERG
REPORTS FROM THE KEVO SUBARCTIC RESEARCH STATION = REP KEVO SUBARCTIC
REPORTS ON MATHEMATICAL PHYSICS = REP MATH PHYS
REPORTS ON PROGRESS IN PHYSICS = REP PROG PHYS
REPRESENTATIONS = REPRESENTATIONS
REPRODUCTION FERTILITY AND DEVELOPMENT = REPROD FERT DEVELOP
REPRODUCTION IN DOMESTIC ANIMALS = REPROD DOMEST ANIM
REPRODUCTION NUTRITION DEVELOPMENT = REPROD NUTR DEV
REPRODUCTIVE TOXICOLOGY = REPROD TOXICOL
RERIC INTERNATIONAL ENERGY JOURNAL = RERIC INT ENERG J
RES MECHANICA = RES MECH
RESEARCH & DEVELOPMENT = RES DEV
RESEARCH & EXPLORATION = RES EXPLOR
RESEARCH AND DEVELOPMENT IN AGRICULTURE = RES DEV AGRIC
RESEARCH AND INDUSTRY = RES IND
RESEARCH COMMUNICATIONS IN ALCOHOL AND SUBSTANCES OF ABUSE = RES COMMUN ALCOHOL S
RESEARCH COMMUNICATIONS IN CHEMICAL PATHOLOGY AND PHARMACOLOGY = RES COMMUN CHEM PATH
RESEARCH COMMUNICATIONS IN MOLECULAR PATHOLOGY AND PHARMACOLOGY = RES COMMUN MOL PATH
RESEARCH COMMUNICATIONS IN PSYCHOLOGY PSYCHIATRY AND BEHAVIOR = RES COMMUN PSYCH PSY
RESEARCH COMMUNICATIONS IN SUBSTANCES OF ABUSE = RES COMMUN SUBSTANCE
RESEARCH IN AFRICAN LITERATURES = RES AFR LITERATURES
RESEARCH IN CLINIC AND LABORATORY = RES CLIN LAB
RESEARCH IN DEVELOPMENTAL DISABILITIES = RES DEV DISABIL
RESEARCH IN ENGINEERING DESIGN-THEORY APPLICATIONS AND CONCURRENT ENGINEERING = RES ENG DES
RESEARCH IN EXPERIMENTAL MEDICINE = RES EXP MED
RESEARCH IN HIGHER EDUCATION = RES HIGH EDUC
RESEARCH IN IMMUNOLOGY = RES IMMUNOL
RESEARCH IN MICROBIOLOGY = RES MICROBIOL
RESEARCH IN NONDESTRUCTIVE EVALUATION = RES NONDESTRUCT EVAL
RESEARCH IN NURSING & HEALTH = RES NURS HEALTH
RESEARCH IN ORGANIZATIONAL BEHAVIOR = RES ORGAN BEHAV
RESEARCH IN PHENOMENOLOGY = RES PHENOMENOL
RESEARCH IN THE TEACHING OF ENGLISH = RES TEACH ENGL
RESEARCH IN VETERINARY SCIENCE = RES VET SCI
RESEARCH IN VIROLOGY = RES VIROLOGY
RESEARCH JOURNAL OF THE WATER POLLUTION CONTROL FEDERATION = RES J WATER POLLUT C
RESEARCH MANAGEMENT = RES MANAGE
RESEARCH ON AGING = RES AGING
RESEARCH ON CHEMICAL INTERMEDIATES = RES CHEM INTERMEDIAT
RESEARCH ON LANGUAGE AND SOCIAL INTERACTION = RES LANG SOC INTERAC
RESEARCH ON SOCIAL WORK PRACTICE = RES SOCIAL WORK PRAC
RESEARCH POLICY = RES POLICY
RESEARCH PUBLICATIONS-ASSOCIATION FOR RESEARCH IN NERVOUS AND MENTAL DISEASE = RES PUBL ASSOC RES N
RESEARCH QUARTERLY FOR EXERCISE AND SPORT = RES Q EXERCISE SPORT
RESEARCH-TECHNOLOGY MANAGEMENT = RES TECHNOL MANAGE
RESEARCHES ON POPULATION ECOLOGY = RES POPUL ECOL
RESIDUE REVIEWS = RESIDUE REV
RESOURCE AND ENERGY ECONOMICS = RESOUR ENERGY ECON
RESOURCE GEOLOGY = RESOUR GEOL
RESOURCE MANAGEMENT AND OPTIMIZATION = RESOUR MANAGE OPT
RESOURCES AND CONSERVATION = RESOUR CONSERV
RESOURCES AND ENERGY = RESOUR ENERG
RESOURCES CONSERVATION AND RECYCLING = RESOUR CONSERV RECY
RESOURCES FOR AMERICAN LITERARY STUDY = RESOUR AM LIT STUD
RESOURCES POLICY = RESOUR POLICY
RESPIRATION = RESPIRATION
RESPIRATION PHYSIOLOGY = RESP PHYSIOL
RESPIRATORY MEDICINE = RESP MED
RESPONSIVE COMMUNITY = RESPONSIVE COMMUNITY
RESTAURATOR-INTERNATIONAL JOURNAL FOR THE PRESERVATION OF LIBRARY AND ARCHIVAL MATERIAL = RESTAURATOR
RESTORATION ECOLOGY = RESTOR ECOL
RESTORATIVE NEUROLOGY AND NEUROSCIENCE = RESTOR NEUROL NEUROS
RESUSCITATION = RESUSCITATION
RETHINKING HISTORY = RETHINK HIST
RETINA-THE JOURNAL OF RETINAL AND VITREOUS DISEASES = RETINA-J RET VIT DIS
REVIEW OF BLACK POLITICAL ECONOMY = REV BLACK POLIT ECON
REVIEW OF ECONOMIC CONDITIONS IN ITALY = REV ECON COND ITALY
REVIEW OF ECONOMIC STUDIES = REV ECON STUD
REVIEW OF ECONOMICS AND STATISTICS = REV ECON STAT
REVIEW OF EDUCATIONAL RESEARCH = REV EDUC RES
REVIEW OF ENGLISH STUDIES = REV ENGL STUD
REVIEW OF FINANCIAL STUDIES = REV FINANC STUD
REVIEW OF HIGHER EDUCATION = REV HIGH EDUC
REVIEW OF INCOME AND WEALTH = REV INCOME WEALTH
REVIEW OF INDUSTRIAL ORGANIZATION = REV IND ORGAN
REVIEW OF INTERNATIONAL POLITICAL ECONOMY = REV INT POLIT ECON
REVIEW OF INTERNATIONAL STUDIES = REV INT STUD
REVIEW OF METAPHYSICS = REV METAPHYS
REVIEW OF PALAEOBOTANY AND PALYNOLOGY = REV PALAEOBOT PALYNO
REVIEW OF RELIGIOUS RESEARCH = REV RELIG RES
REVIEW OF RESEARCH IN EDUCATION = REV RES EDUC
REVIEW OF RESEARCH IN EDUCATION 22, 1997 = REV RES EDUC
REVIEW OF RESEARCH IN EDUCATION, 20, 1994 = REV RES EDUC
REVIEW OF RESEARCH IN EDUCATION, 21 = REV RES EDUC
REVIEW OF RESEARCH IN EDUCATION, 23, 1998 = REV RES EDUC
REVIEW OF RESEARCH IN EDUCATION, 24 1999 = REV RES EDUC
REVIEW OF SCIENTIFIC INSTRUMENTS = REV SCI INSTRUM
REVIEW OF SOCIAL ECONOMY = REV SOC ECON
REVIEW OF THE ELECTRICAL COMMUNICATIONS LABORATORIES = REV ELEC COMMUN LAB
REVIEW-LATIN AMERICAN LITERATURE AND ARTS = REVIEW-LAT AM LIT
REVIEWS IN AMERICAN HISTORY = REV AM HIST
REVIEWS IN ANALYTICAL CHEMISTRY = REV ANAL CHEM
REVIEWS IN AQUATIC SCIENCES = REV AQUAT SCI
REVIEWS IN BIOCHEMICAL TOXICOLOGY = REV BIOCHEM TOXICOL
REVIEWS IN CHEMICAL ENGINEERING = REV CHEM ENG
REVIEWS IN COMPUTATIONAL CHEMISTRY = REV COMP CH
REVIEWS IN CONTEMPORARY PHARMACOTHERAPY = REV CONTEMP PHARMACO
REVIEWS IN FISH BIOLOGY AND FISHERIES = REV FISH BIOL FISHER
REVIEWS IN INORGANIC CHEMISTRY = REV INORG CHEM
REVIEWS IN MATHEMATICAL PHYSICS = REV MATH PHYS
REVIEWS IN MEDICAL MICROBIOLOGY = REV MED MICROBIOL
REVIEWS IN MEDICAL VIROLOGY = REV MED VIROL
REVIEWS IN MINERALOGY = REV MINERAL
REVIEWS IN PARTICULATE MATERIALS = REV PARTICUL MATER
REVIEWS IN PERINATAL MEDICINE = REV PERINATAL MED
REVIEWS IN THE NEUROSCIENCES = REV NEUROSCIENCE
REVIEWS OF CHEMICAL INTERMEDIATES = REV CHEM INTERMED
REVIEWS OF ENVIRONMENTAL CONTAMINATION AND TOXICOLOGY = REV ENVIRON CONTAM T
REVIEWS OF GEOPHYSICS = REV GEOPHYS
REVIEWS OF INFECTIOUS DISEASES = REV INFECT DIS
REVIEWS OF MODERN PHYSICS = REV MOD PHYS
REVIEWS OF PHYSIOLOGY BIOCHEMISTRY AND PHARMACOLOGY = REV PHYSIOL BIOCH P
REVIEWS OF PHYSIOLOGY, BIOCHEMISTRY AND PHARMACOLOGY = REV PHYSIOL BIOCH P
REVIEWS OF REPRODUCTION = REV REPROD
REVIEWS ON ENVIRONMENTAL HEALTH = REV ENVIRON HEALTH
REVIEWS ON HETEROATOM CHEMISTRY = REV HETEROATOM CHEM
REVISTA BRASILEIRA DE GENETICA = BRAZ J GENET
REVISTA BRASILEIRA DE GENETICA = REV BRAS GENET
REVISTA BRASILEIRA DE MEDICINA = REV BRAS MED
REVISTA BRASILEIRA DE ZOOTECNIA-BRAZILIAN JOURNAL OF ANIMAL SCIENCE = REV BRAS ZOOTECN
REVISTA CHILENA DE HISTORIA NATURAL = REV CHIL HIST NAT
REVISTA CHILENA DE LITERATURA = REV CHIL LIT
REVISTA CIENTIFICA-FACULTAD DE CIENCIAS VETERINARIAS = REV CIENT-FAC CIEN V
REVISTA CLINICA ESPANOLA = REV CLIN ESP
REVISTA DA SOCIEDADE BRASILEIRA DE ZOOTECNIA-JOURNAL OF THE BRAZILIAN SOCIETY OF ANIMAL SCIENCE = REV SOC BRAS ZOOTECN
REVISTA DE AGROQUIMICA Y TECNOLOGIA DE ALIMENTOS = REV AGROQUIM TECNOL
REVISTA DE BIOLOGIA TROPICAL = REV BIOL TROP
REVISTA DE CHIMIE = REV CHIM-BUCHAREST
REVISTA DE CRITICA LITERARIA LATINOAMERICANA = REV CRIT LIT LATINO
REVISTA DE DIALECTOLOGIA Y TRADICIONES POPULARES = REV DIALECT TRAD POP
REVISTA DE ESTUDIOS HISPANICOS = REV ESTUD HISPAN
REVISTA DE FILOLOGIA ESPANOLA = REV FILOL ESPAN
REVISTA DE HISTORIA DE AMERICA = REV HIST AM
REVISTA DE INDIAS = REV INDIAS
REVISTA DE INFORMATICA Y AUTOMATICA = REV INFORM AUTOMAT
REVISTA DE INVESTIGACION CLINICA = REV INVEST CLIN
REVISTA DE LITERATURA = REV LITERATURA
REVISTA DE METALURGIA = REV METAL MADRID
REVISTA DE MICROBIOLOGIA = REV MICROBIOL
REVISTA DE NEUROLOGIA = REV NEUROLOGIA
REVISTA DE OCCIDENTE = REV OCCIDENTE
REVISTA DE SAUDE PUBLICA = REV SAUDE PUBL
REVISTA DO INSTITUTO DE MEDICINA TROPICAL DE SAO PAULO = REV I MED TROP
REVISTA DOYMA DE INMUNOLOGIA = REV DOYMA INMUN
REVISTA ECUATORIANA DE NEUROLOGIA = REV ECUAT NEUROL
REVISTA ESPANOLA DE CARDIOLOGIA = REV ESP CARDIOL
REVISTA ESPANOLA DE CIENCIA Y TECNOLOGIA DE ALIMENTOS = REV ESP CIEN TEC ALI
REVISTA ESPANOLA DE ENFERMEDADES DIGESTIVAS = REV ESP ENFERM DIG
REVISTA ESPANOLA DE FISIOLOGIA = REV ESP FISIOL
REVISTA ESPANOLA DE LAS ENFERMEDADES DEL APARATO DIGESTIVO = REV ESP ENFERM APAR
REVISTA GEOLOGICA DE CHILE = REV GEOL CHILE
REVISTA IBEROAMERICANA = REV IBEROAMERICANA
REVISTA INTERAMERICANA DE PSICOLOGIA = REV INTERAM PSICOL
REVISTA LATINOAMERICANA DE INGENIERIA QUIMICA Y QUIMICA APLICADA-LATIN AMERICAN JOURNAL OF CHEMICAL ENGINEERING AND APPLIED CHEMISTRY = REV LAT AM ING QUIM
REVISTA LATINOAMERICANA DE PSICOLOGIA = REV LAT AM PSICOL
REVISTA MATEMATICA IBEROAMERICANA = REV MAT IBEROAM
REVISTA MEDICA DE CHILE = REV MED CHILE
REVISTA MEXICANA DE ASTRONOMIA Y ASTROFISICA = REV MEX ASTRON ASTR
REVISTA MEXICANA DE FISICA = REV MEX FIS
REVISTA MEXICANA DE PSICOLOGIA = REV MEX PSICOL
REVISTA MEXICANA DE RADIOLOGIA = REV MEX RADIOL
REVISTA TECNICA INTEVEP = REV TEC INTEVEP
REVUE BELGE DE PHILOLOGIE ET D HISTOIRE = REV BELGE PHILOL HIS
REVUE BIBLIQUE = REV BIBLIQUE
REVUE CANADIENNE D ETUDES DU DEVELOPPEMENT-CANADIAN JOURNAL OF DEVELOPMENT STUDIES = REV CAN ETUD DEV
REVUE CANADIENNE DE BIOLOGIE = REV CAN BIOL EXPTL
REVUE CANADIENNE DE BIOLOGIE EXPERIMENTALE = REV CAN BIOL EXPTL
REVUE CANADIENNE DES SCIENCES DE L ADMINISTRATION-CANADIAN JOURNAL OF ADMINISTRATIVE SCIENCES = REV CAN SCI ADMIN
REVUE D ECOLOGIE ET DE BIOLOGIE DU SOL = REV ECOL BIOL SOL
REVUE D ECOLOGIE-LA TERRE ET LA VIE = REV ECOL-TERRE VIE
REVUE D ELEVAGE ET DE MEDECINE VETERINAIRE DES PAYS TROPICAUX = REV ELEV MED VET PAY
REVUE D EPIDEMIOLOGIE ET DE SANTE PUBLIQUE = REV EPIDEMIOL SANTE
REVUE D ESTHETIQUE = REV ESTHET
REVUE D ETUDES COMPARATIVES EST-OUEST = REV ETUD COMP EST-Q
REVUE D HISTOIRE DE L AMERIQUE FRANCAISE = REV HIST AM FR
REVUE D HISTOIRE DU THEATRE = REV HIST THEATRE
REVUE D HISTOIRE ECCLESIASTIQUE = REV HIST ECCLESIAST
REVUE D HISTOIRE LITTERAIRE DE LA FRANCE = REV HIST LIT FR
REVUE D HISTOIRE MODERNE ET CONTEMPORAINE = REV HIST MOD CONTEMP
REVUE DE CHIMIE MINERALE = REV CHIM MINER
REVUE DE CHIRURGIE ORTHOPEDIQUE ET REPARATRICE DE L APPAREIL MOTEUR = REV CHIR ORTHOP
REVUE DE GEOLOGIE DYNAMIQUE ET DE GEOGRAPHIE PHYSIQUE = REV GEOL DYN GEOGR
REVUE DE L AGRICULTURE = REV AGR-BRUSSELS
REVUE DE L ART = REV ART
REVUE DE L HISTOIRE DES RELIGIONS = REV HIST RELIG
REVUE DE L INSTITUT FRANCAIS DU PETROLE = REV I FR PETROL
REVUE DE LINGUISTIQUE ROMANE = REV LINGUIST ROMAN
REVUE DE MEDECINE = REV MED-PARIS
REVUE DE MEDECINE DE TOULOUSE = REV MED TOULOUSE
REVUE DE MEDECINE INTERNE = REV MED INTERNE
REVUE DE MEDECINE VETERINAIRE = REV MED VET-TOULOUSE
REVUE DE METALLURGIE-CAHIERS D INFORMATIONS TECHNIQUES = REV METALL-PARIS
REVUE DE METAPHYSIQUE ET DE MORALE = REV METAPHYS MORALE
REVUE DE MUSICOLOGIE = REV MUSICOL
REVUE DE NEUROPSYCHOLOGIE = REV NEUROPSYCHOL
REVUE DE PHILOLOGIE DE LITTERATURE ET D HISTOIRE ANCIENNES = REV PHILOL LIT HIST
REVUE DE PHYSIQUE APPLIQUEE = REV PHYS APPL
REVUE DE STOMATOLOGIE ET DE CHIRURGIE MAXILLO-FACIALE = REV STOMATOL CHIR
REVUE DES ETUDES ITALIENNES = REV ETUD ITAL
REVUE DES ETUDES JUIVES = REV ETUD JUIVES
REVUE DES ETUDES LATINES = REV ETUD LATIN
REVUE DES FERMENTATIONS ET DES INDUSTRIES ALIMENTAIRES = REV FERMENT IND ALIM
REVUE DES LANGUES ROMANES = REV LANGUES ROMANES
REVUE DES MALADIES RESPIRATOIRES = REV MAL RESPIR
REVUE DES SCIENCES HUMAINES = REV SCI HUMAINES
REVUE DES SCIENCES PHILOSOPHIQUES ET THEOLOGIQUES = REV SCI PHILOS THEOL
REVUE DU LOUVRE-LA REVUE DES MUSEES DE FRANCE = REV LOUVRE
REVUE DU NORD = REV NORD
REVUE DU PRATICIEN = REV PRATICIEN
REVUE DU RHUMATISME = REV RHUM
REVUE ECONOMIQUE = REV ECON
REVUE FRANCAISE D ALLERGOLOGIE ET D IMMUNOLOGIE CLINIQUE = REV FR ALLERGOL
REVUE FRANCAISE D ETUDES AMERICAINES = REV FR ETUD AMER
REVUE FRANCAISE DE PSYCHANALYSE = REV FR PSYCHANAL
REVUE FRANCAISE DE SOCIOLOGIE = REV FR SOCIOL
REVUE FRANCAISE DE TRANSFUSION ET D HEMOBIOLOGIE = REV FR TRANSFUS HEM
REVUE FRANCAISE DE TRANSFUSION ET IMMUNO-HEMATOLOGIE = REV FR TRANSFUS IMMU
REVUE FRANCAISE DES CORPS GRAS = REV FR CORPS GRAS
REVUE FRANCAISE DES MALADIES RESPIRATOIRES = REV FR MAL RESPIR
REVUE GENERALE DE THERMIQUE = REV GEN THERM
REVUE HISTORIQUE = REV HISTORIQUE
REVUE INTERNATIONALE DE PHILOSOPHIE = REV INT PHILOS
REVUE INTERNATIONALE DES HAUTES TEMPERATURES ET DES REFRACTAIRES = REV INT HAUTES TEMP
REVUE MAROCAINE DE MEDECINE ET SANTE = REV MAROC MED SANTE
REVUE NEUROLOGIQUE = REV NEUROL
REVUE PHILOSOPHIQUE DE LA FRANCE ET DE L ETRANGER = REV PHILOS FR ETRANG
REVUE PHILOSOPHIQUE DE LOUVAIN = REV PHILOS LOUVAIN
REVUE ROMANE = REV ROMANE
REVUE ROUMAINE D HISTOIRE = REV ROUM HIST
REVUE ROUMAINE DE BIOCHIMIE = REV ROUM BIOCHIM
REVUE ROUMAINE DE CHIMIE = REV ROUM CHIM
REVUE ROUMAINE DE MATHEMATIQUES PURES ET APPLIQUEES = REV ROUM MATH PURE A
REVUE ROUMAINE DE MEDECINE-MEDECINE INTERNE = REV ROUM MED-MED INT
REVUE ROUMAINE DE PHYSIQUE = REV ROUM PHYS
REVUE SCIENTIFIQUE ET TECHNIQUE DE L OFFICE INTERNATIONAL DES EPIZOOTIES = REV SCI TECH OIE
REVUE SUISSE DE ZOOLOGIE = REV SUISSE ZOOL
REVUE TECHNIQUE THOMSON-CSF = REV TECH THOMSON
REVUE THEOLOGIQUE DE LOUVAIN = REV THEOL LOUVAIN
RHEOLOGICA ACTA = RHEOL ACTA
RHEOLOGY = RHEOLOGY
RHETORICA-A JOURNAL OF THE HISTORY OF RHETORIC = RHETORICA
RHEUMATIC DISEASE CLINICS OF NORTH AMERICA = RHEUM DIS CLIN N AM
RHEUMATOLOGY = RHEUMATOLOGY
RHEUMATOLOGY AND REHABILITATION = RHEUMATOL REHABIL
RHEUMATOLOGY INTERNATIONAL = RHEUMATOL INT
RHODE ISLAND MEDICAL JOURNAL = R I MED J
RHODIUM EXPRESS = RHODIUM EXPRESS
RHODORA = RHODORA
RICE JOURNAL = RICE J
RICERCA IN CLINICA E IN LABORATORIO = RES CLIN LAB
RICERCHE DI MATEMATICA = RIC MAT
RICERCHE DI STORIA DELL ARTE = RIC STOR ARTE
RINASCIMENTO = RINASCIMENTO
RISK ANALYSIS = RISK ANAL
RISORGIMENTO = RISORGIMENTO
RIVERS-STUDIES IN THE SCIENCE ENVIRONMENTAL POLICY AND LAW OF INSTREAM FLOW = RIVERS-STUD SCI ENV
RIVISTA AERONAUTICA = RIV AERONAUT
RIVISTA DEL NUOVO CIMENTO = RIV NUOVO CIMENTO
RIVISTA DI AGRICOLTURA SUBTROPICALE E TROPICALE = RIV AGR SUBTROP TROP
RIVISTA DI BIOLOGIA-BIOLOGY FORUM = RIV BIOL-BIOL FORUM
RIVISTA DI ECONOMIA AGRARIA = RIV ECON AGR
RIVISTA DI FILOSOFIA NEO-SCOLASTICA = RIV FILOS NEO-SCOLAS
RIVISTA DI LETTERATURE MODERNE E COMPARATE = RIV LETT MOD COMP
RIVISTA DI METEOROLOGIA AERONAUTICA = RIV METEOROL AERONAU
RIVISTA DI NEURORADIOLOGIA = RIV NEURORADIOL
RIVISTA DI PATOLOGIA VEGETALE = RIV PATOL VEG
RIVISTA DI STORIA CONTEMPORANEA = RIV STORIA CONTEMP
RIVISTA DI STORIA DELLA FILOSOFIA = RIV STOR FILOS
RIVISTA DI STORIA E LETTERATURA RELIGIOSA = RIV STOR LETT RELIG
RIVISTA ITALIANA DI MUSICOLOGIA = RIV ITAL MUSIC
RIVISTA ITALIANA DI PALEONTOLOGIA E STRATIGRAFIA = RIV ITAL PALEONTOL S
RIVISTA ITALIANA DI PEDIATRIA-ITALIAN JOURNAL OF PEDIATRICS = RIV ITAL PED
RIVISTA STORICA ITALIANA = RIV STORICA ITAL
RLC-REVUE DE LITTERATURE COMPAREE = RLC-REV LIT COMP
RN MAGAZINE = RN MAG
RNA-A PUBLICATION OF THE RNA SOCIETY = RNA
ROBOTERSYSTEME = ROBOTERSYSTEME
ROBOTICA = ROBOTICA
ROBOTICS AGE = ROBOTIC AGE
ROBOTICS AND AUTONOMOUS SYSTEMS = ROBOT AUTON SYST
ROBOTICS AND COMPUTER-INTEGRATED MANUFACTURING = ROBOT CIM-INT MANUF
ROCK MECHANICS = ROCK MECH
ROCK MECHANICS AND ROCK ENGINEERING = ROCK MECH ROCK ENG
ROCK PRODUCTS = ROCK PROD
ROCKY MOUNTAIN INSTITUTE NEWSLETTER = ROCKY MT INST NEWSL
ROCKY MOUNTAIN JOURNAL OF MATHEMATICS = ROCKY MT J MATH
ROFO-FORTSCHRITTE AUF DEM GEBIET DER RONTGENSTRAHLEN UND DER BILDGEBENDEN VERFAHREN = ROFO-FORTSCHR RONTG
ROMANCE NOTES = ROMANCE NOTES
ROMANCE PHILOLOGY = ROMANCE PHILOL
ROMANCE QUARTERLY = ROMANCE QUART
ROMANISCHE FORSCHUNGEN = ROMAN FORSCH
ROMANISTISCHE ZEITSCHRIFT FUR LITERATURGESCHICHTE-CAHIERS D HISTOIRE DES LITTERATURES ROMANES = ROMAN Z LIT-CAH HIST
ROMANTISME = ROMANTISME
ROSTLINNA VYROBA = ROST VYROBA
ROUXS ARCHIVES OF DEVELOPMENTAL BIOLOGY = ROUX ARCH DEV BIOL
ROYAL SOCIETY OF HEALTH JOURNAL = ROY SOC HEALTH J
RQ = RQ
RUBBER CHEMISTRY AND TECHNOLOGY = RUBBER CHEM TECHNOL
RURAL SOCIOLOGY = RURAL SOCIOL
RUSSELL-THE JOURNAL OF THE BERTRAND RUSSELL ARCHIVES = RUSSELL
RUSSIAN ACADEMY OF SCIENCES IZVESTIYA MATHEMATICS = RUSS AC SC IZV MATH+
RUSSIAN ACADEMY OF SCIENCES SBORNIK MATHEMATICS = RUSS AC SC SB MATH+
RUSSIAN AND EAST EUROPEAN FINANCE AND TRADE = RUSS E EUR FINANC TR
RUSSIAN CHEMICAL BULLETIN = RUSS CHEM B+
RUSSIAN EDUCATION AND SOCIETY = RUSS EDUC SOC
RUSSIAN ELECTROCHEMISTRY = RUSS ELECTROCHEM+
RUSSIAN HISTORY-HISTOIRE RUSSE = RUSS HIST-HIST RUSS
RUSSIAN JOURNAL OF APPLIED CHEMISTRY = RUSS J APPL CHEM+
RUSSIAN JOURNAL OF COORDINATION CHEMISTRY = RUSS J COORD CHEM+
RUSSIAN JOURNAL OF ECOLOGY = RUSS J ECOL+
RUSSIAN JOURNAL OF ELECTROCHEMISTRY = RUSS J ELECTROCHEM+
RUSSIAN JOURNAL OF GENERAL CHEMISTRY = RUSS J GEN CHEM
RUSSIAN JOURNAL OF GENETICS = RUSS J GENET+
RUSSIAN JOURNAL OF MATHEMATICAL PHYSICS = RUSS J MATH PHYS
RUSSIAN JOURNAL OF NEMATOLOGY = RUSS J NEMATOL
RUSSIAN JOURNAL OF NONDESTRUCTIVE TESTING = RUSS J NONDESTRUCT+
RUSSIAN JOURNAL OF NUMERICAL ANALYSIS AND MATHEMATICAL MODELLING = RUSS J NUMER ANAL M
RUSSIAN JOURNAL OF PHYSICAL CHEMISTRY = RUSS J PHYS CH
RUSSIAN JOURNAL OF PHYSICAL CHEMISTRY = RUSS J PHYS CHEM+
RUSSIAN JOURNAL OF PLANT PHYSIOLOGY = RUSS J PLANT PHYSL+
RUSSIAN LINGUISTICS = RUSS LINGUIST
RUSSIAN LITERATURE = RUSS LITERATURE
RUSSIAN MATHEMATICAL SURVEYS = RUSS MATH SURV+
RUSSIAN METALLURGY = RUSS METALL+
RUSSIAN PLANT PHYSIOLOGY = RUSS PLANT PHYSIOL+
RUSSIAN POLITICS AND LAW = RUSS POLIT LAW
RUSSIAN REVIEW = RUSS REV
RUSSIAN STUDIES IN LITERATURE = RUSS STUD LIT
RUSSIAN STUDIES IN PHILOSOPHY = RUSS STUD PHILOS
RUSSIAN ULTRASONICS = RUSS ULTRASON
RUSSKAIA LITERATURA = RUSS LITERATURA
RUTGERS LAW REVIEW = RUTGERS LAW REV
