B LYMPHOCYTES AND AUTOIMMUNITY = ANN NY ACAD SCI
B'98: RECENT ADVANCES IN THE DEVELOPMENT AND USE OF THE B METHOD = LECT NOTES COMPUT SC
BACH = BACH
BACKER UND KONDITOR = BACKER KONDITOR
BACTERIAL INFECTION: CLOSE ENCOUNTERS AT THE HOST PATHOGEN INTERFACE = CURR TOP MICROBIOL
BACTERIAL INVASIVENESS = CURR TOP MICROBIOL
BACTERIAL PATHOGENESIS, PT A = METHOD ENZYMOL
BACTERIAL PATHOGENESIS, PT B = METHOD ENZYMOL
BACTERIAL RESPONSE TO PH = NOVART FDN SYMP
BAILLIERES CLINICAL ANAESTHESIOLOGY = BAILLIERE CLIN ANAES
BAILLIERES CLINICAL ENDOCRINOLOGY AND METABOLISM = BAILLIERE CLIN ENDOC
BAILLIERES CLINICAL GASTROENTEROLOGY = BAILLIERE CLIN GASTR
BAILLIERES CLINICAL HAEMATOLOGY = BAILLIERE CLIN HAEM
BAILLIERES CLINICAL HAEMATOLOGY-INTERNATIONAL PRACTICE AND RESEARCH = BAIL CL HAE
BAILLIERES CLINICAL INFECTIOUS DISEASES = BAILLIERE CLIN INF D
BAILLIERES CLINICAL NEUROLOGY = BAILLIERE CLIN NEUR
BAILLIERES CLINICAL OBSTETRICS AND GYNAECOLOGY = BAILLIERE CLIN OB GY
BAILLIERES CLINICAL RHEUMATOLOGY = BAILLIERE CLIN RHEUM
BAKERS DIGEST = BAKERS DIG
BALANCE CONTROL OF FLEXIBLE STRUCTURES = LECT NOTES CONTR INF
BALLET REVIEW = BALLET REV
BALLETT INTERNATIONAL = BALLETT INT
BALLETT INTERNATIONAL-TANZ AKTUELL = BALLETT INT-TANZ AKT
BALLOON TECHNOLOGY AND OBSERVATIONS = ADV SPACE RES
BAMIDGEH = BAMIDGEH
BANGLADESH JOURNAL OF BOTANY = BANGLADESH J BOTANY
BANKING LAW JOURNAL = BANKING LAW J
BARODA JOURNAL OF NUTRITION = BARODA J NUTR
BASIC AND APPLIED HISTOCHEMISTRY = BASIC APPL HISTOCHEM
BASIC AND APPLIED MYOLOGY = BASIC APPL MYOL
BASIC AND APPLIED SOCIAL PSYCHOLOGY = BASIC APPL SOC PSYCH
BASIC RESEARCH IN CARDIOLOGY = BASIC RES CARDIOL
BASIN RESEARCH = BASIN RES
BASIS FOR CANCER MANAGEMENT = ANN NY ACAD SCI
BEE WORLD = BEE WORLD
BEHAVIOR ANALYST = BEHAV ANALYST
BEHAVIOR AND PHILOSOPHY = BEHAV PHILOS
BEHAVIOR GENETICS = BEHAV GENET
BEHAVIOR MODIFICATION = BEHAV MODIF
BEHAVIOR RESEARCH METHODS INSTRUMENTS & COMPUTERS = BEHAV RES METH INS C
BEHAVIOR RESEARCH METHODS INSTRUMENTS & COMPUTERS = BEHAV RES METH INSTR
BEHAVIOR THERAPY = BEHAV THER
BEHAVIORAL & SOCIAL SCIENCES LIBRARIAN = BEHAV SOC SCI LIBR
BEHAVIORAL AND BRAIN SCIENCES = BEHAV BRAIN SCI
BEHAVIORAL AND NEURAL BIOLOGY = BEHAV NEURAL BIOL
BEHAVIORAL DISORDERS = BEHAV DISORDERS
BEHAVIORAL ECOLOGY = BEHAV ECOL
BEHAVIORAL ECOLOGY AND SOCIOBIOLOGY = BEHAV ECOL SOCIOBIOL
BEHAVIORAL HEALTHCARE TOMORROW = BEHAV HEALTHC TOM
BEHAVIORAL INTERVENTIONS = BEHAV INTERVENT
BEHAVIORAL MEDICINE = BEHAV MED
BEHAVIORAL NEUROSCIENCE = BEHAV NEUROSCI
BEHAVIORAL SCIENCE = BEHAV SCI
BEHAVIORAL SCIENCES & THE LAW = BEHAV SCI LAW
BEHAVIOUR = BEHAVIOUR
BEHAVIOUR & INFORMATION TECHNOLOGY = BEHAV INFORM TECHNOL
BEHAVIOUR ANALYSIS LETTERS = BEHAV ANAL LETT
BEHAVIOUR CHANGE = BEHAV CHANGE
BEHAVIOUR RESEARCH AND THERAPY = BEHAV RES THER
BEHAVIOURAL AND COGNITIVE PSYCHOTHERAPY = BEHAV COGN PSYCHOTH
BEHAVIOURAL BRAIN RESEARCH = BEHAV BRAIN RES
BEHAVIOURAL NEUROLOGY = BEHAV NEUROL
BEHAVIOURAL PHARMACOLOGY = BEHAV PHARMACOL
BEHAVIOURAL PROCESSES = BEHAV PROCESS
BEITRAGE AUS DER PLASMAPHYSIK-CONTRIBUTIONS TO PLASMA PHYSICS = BEIT PLASMAPHYS-CONT
BEITRAGE ZUR GESCHICHTE DER ARBEITERBEWEGUNG = BEITR GESCH ARBEIT
BEITRAGE ZUR GESCHICHTE DER DEUTSCHEN SPRACHE UND LITERATUR = BEITR GESCH DEUT SPR
BEITRAGE ZUR INFUSIONSTHERAPIE/CONTRIBUTIONS TO INFUSION THERAPY = BEITR INFUS
BEITRAGE ZUR MUSIKWISSENSCHAFT = BEITR MUSIKWISS
BEITRAGE ZUR TABAKFORSCHUNG INTERNATIONAL = BEITR TABAKFORSCH
BEITRAGE ZUR TROPISCHEN LANDWIRTSCHAFT UND VETERINARMEDIZIN = BEITR TROP LANDWIRT
BELFAGOR = BELFAGOR
BELGIAN JOURNAL OF BOTANY = BELG J BOT
BELGIAN JOURNAL OF ZOOLOGY = BELG J ZOOL
BELL LABORATORIES RECORD = BELL LAB REC
BELL LABS TECHNICAL JOURNAL = BELL LABS TECH J
BELL SYSTEM TECHNICAL JOURNAL = AT&T TECH J
BERICHTE DER BUNSEN-GESELLSCHAFT-PHYSICAL CHEMISTRY CHEMICAL PHYSICS = BER BUNSEN PHYS CHEM
BERICHTE DER DEUTSCHEN BOTANISCHEN GESELLSCHAFT = BER DEUT BOT GES
BERICHTE UBER LANDWIRTSCHAFT = BER LANDWIRTSCH
BERLINER JOURNAL FUR SOZIOLOGIE = BERL J SOZIOL
BERLINER UND MUNCHENER TIERARZTLICHE WOCHENSCHRIFT = BERL MUNCH TIERARZTL
BERNOULLI = BERNOULLI
BEST PRACTICE & RESEARCH CLINICAL ENDOCRINOLOGY & METABOLISM = BEST PRACT RES CL EN
BEST PRACTICE & RESEARCH CLINICAL HAEMATOLOGY = BEST PRACT RES CL HA
BEST PRACTICE & RESEARCH IN CLINICAL GASTROENTEROLOGY = BEST PRACT RES CL GA
BEST PRACTICE & RESEARCH IN CLINICAL OBSTETRICS & GYNAECOLOGY = BEST PRACT RES CL OB
BEST PRACTICE & RESEARCH IN CLINICAL RHEUMATOLOGY = BEST PRACT RES CL RH
BETRIEBSWIRTSCHAFTLICHE FORSCHUNG UND PRAXIS = BETRIEB FORSCH PRAX
BIBLICA = BIBLICA
BIBLICAL ARCHAEOLOGIST = BIBLIC ARCHAEOL
BIBLIOTHECA NUTRITIO ET DIETA = BIBL NUTR DIET
BIBLIOTHECA PSYCHIATRICA = BIBL PSYCHIAT
BIBLIOTHEQUE D HUMANISME ET RENAISSANCE = BIBL HUM RENAISSANCE
BIBLIOTHEQUE DE L ECOLE DES CHARTES = BIBL EC CHARTES
BIBLISCHE ZEITSCHRIFT = BIBLISCHE Z
BIJDRAGEN TOT DE DIERKUNDE = BIJDR DIERKD
BIJDRAGEN TOT DE TAAL- LAND- EN VOLKENKUNDE = BIJDR TAAL-LAND-V
BIKEN JOURNAL = BIKEN J
BINARY-COMPUTING IN MICROBIOLOGY = BINARY-COMPUT MICROB
BIO-MEDICAL MATERIALS AND ENGINEERING = BIO-MED MATER ENG
BIO-TECHNOLOGY = BIO-TECHNOL
BIOCATALYSIS = BIOCATALYSIS
BIOCATALYSIS AND BIOTRANSFORMATION = BIOCATAL BIOTRANSFOR
BIOCELL = BIOCELL
BIOCHEMICAL ACTIONS OF HORMONES = BIOCHEM ACTION HORM
BIOCHEMICAL AND BIOPHYSICAL RESEARCH COMMUNICATIONS = BIOCHEM BIOPH RES CO
BIOCHEMICAL AND MOLECULAR MEDICINE = BIOCHEM MOL MED
BIOCHEMICAL ARCHIVES = BIOCHEM ARCH
BIOCHEMICAL EDUCATION = BIOCHEM EDUC
BIOCHEMICAL ENGINEERING JOURNAL = BIOCHEM ENG J
BIOCHEMICAL GENETICS = BIOCHEM GENET
BIOCHEMICAL JOURNAL = BIOCHEM J
BIOCHEMICAL MEDICINE = BIOCHEM MED METAB B
BIOCHEMICAL MEDICINE AND METABOLIC BIOLOGY = BIOCHEM MED METAB B
BIOCHEMICAL PHARMACOLOGY = BIOCHEM PHARMACOL
BIOCHEMICAL SOCIETY SYMPOSIUM = BIOCHEM SOC SYMP
BIOCHEMICAL SOCIETY TRANSACTIONS = BIOCHEM SOC T
BIOCHEMICAL SYSTEMATICS AND ECOLOGY = BIOCHEM SYST ECOL
BIOCHEMIE UND PHYSIOLOGIE DER PFLANZEN = BIOCHEM PHYSIOL PFL
BIOCHEMISTRY = BIOCHEMISTRY-US
BIOCHEMISTRY AND CELL BIOLOGY-BIOCHIMIE ET BIOLOGIE CELLULAIRE = BIOCHEM CELL BIOL
BIOCHEMISTRY AND MOLECULAR BIOLOGY INTERNATIONAL = BIOCHEM MOL BIOL INT
BIOCHEMISTRY INTERNATIONAL = BIOCHEM INT
BIOCHEMISTRY-MOSCOW = BIOCHEMISTRY-MOSCOW+
BIOCHIMICA ET BIOPHYSICA ACTA = BIOCHIM BIOPHYS ACTA
BIOCHIMICA ET BIOPHYSICA ACTA-BIOENERGETICS = BBA-BIOENERGETICS
BIOCHIMICA ET BIOPHYSICA ACTA-BIOMEMBRANES = BBA-BIOMEMBRANES
BIOCHIMICA ET BIOPHYSICA ACTA-GENE STRUCTURE AND EXPRESSION = BBA-GENE STRUCT EXPR
BIOCHIMICA ET BIOPHYSICA ACTA-GENERAL SUBJECTS = BBA-GEN SUBJECTS
BIOCHIMICA ET BIOPHYSICA ACTA-LIPIDS AND LIPID METABOLISM = BBA-LIPID LIPID MET
BIOCHIMICA ET BIOPHYSICA ACTA-MOLECULAR AND CELL BIOLOGY OF LIPIDS = BBA-MOL CELL BIOL L
BIOCHIMICA ET BIOPHYSICA ACTA-MOLECULAR BASIS OF DISEASE = BBA-MOL BASIS DIS
BIOCHIMICA ET BIOPHYSICA ACTA-MOLECULAR CELL RESEARCH = BBA-MOL CELL RES
BIOCHIMICA ET BIOPHYSICA ACTA-PROTEIN STRUCTURE AND MOLECULAR ENZYMOLOGY = BBA-PROTEIN STRUCT M
BIOCHIMICA ET BIOPHYSICA ACTA-REVIEWS ON BIOMEMBRANES = BBA-REV BIOMEMBRANES
BIOCHIMICA ET BIOPHYSICA ACTA-REVIEWS ON CANCER = BBA-REV CANCER
BIOCHIMIE = BIOCHIMIE
BIOCONJUGATE CHEMISTRY = BIOCONJUGATE CHEM
BIOCONTROL = BIOCONTROL
BIOCONTROL SCIENCE AND TECHNOLOGY = BIOCONTROL SCI TECHN
BIOCYCLE = BIOCYCLE
BIODEGRADATION = BIODEGRADATION
BIODIVERSITY AND CONSERVATION = BIODIVERS CONSERV
BIODRUGS = BIODRUGS
BIOELECTROCHEMISTRY AND BIOENERGETICS = BIOELECTROCH BIOENER
BIOELECTROMAGNETICS = BIOELECTROMAGNETICS
BIOESSAYS = BIOESSAYS
BIOETHICS = BIOETHICS
BIOFACTORS = BIOFACTORS
BIOFEEDBACK AND SELF-REGULATION = BIOFEEDBACK SELF-REG
BIOFIZIKA = BIOFIZIKA+
BIOFOULING = BIOFOULING
BIOFUTUR = BIOFUTUR
BIOGENIC AMINES = BIOGENIC AMINES
BIOGEOCHEMISTRY = BIOGEOCHEMISTRY
BIOGRAPHY-AN INTERDISCIPLINARY QUARTERLY = BIOGRAPHY
BIOIMAGING = BIOIMAGING
BIOINFORMATICS = BIOINFORMATICS
BIOLOGIA = BIOLOGIA
BIOLOGIA PLANTARUM = BIOL PLANTARUM
BIOLOGICAL & PHARMACEUTICAL BULLETIN = BIOL PHARM BULL
BIOLOGICAL AGRICULTURE & HORTICULTURE = BIOL AGRIC HORTIC
BIOLOGICAL BULLETIN = BIOL BULL
BIOLOGICAL CHEMISTRY = BIOL CHEM
BIOLOGICAL CHEMISTRY HOPPE-SEYLER = BIOL CHEM H-S
BIOLOGICAL CONSERVATION = BIOL CONSERV
BIOLOGICAL CONTROL = BIOL CONTROL
BIOLOGICAL CYBERNETICS = BIOL CYBERN
BIOLOGICAL JOURNAL OF THE LINNEAN SOCIETY = BIOL J LINN SOC
BIOLOGICAL MASS SPECTROMETRY = BIOL MASS SPECTROM
BIOLOGICAL MEMBRANES = BIOL MEMBR
BIOLOGICAL PSYCHIATRY = BIOL PSYCHIAT
BIOLOGICAL PSYCHOLOGY = BIOL PSYCHOL
BIOLOGICAL RESEARCH = BIOL RES
BIOLOGICAL RESEARCH IN PREGNANCY AND PERINATOLOGY = BIOL RES PREG PERIN
BIOLOGICAL REVIEWS OF THE CAMBRIDGE PHILOSOPHICAL SOCIETY = BIOL REV
BIOLOGICAL RHYTHM RESEARCH = BIOL RHYTHM RES
BIOLOGICAL SIGNALS = BIOL SIGNAL
BIOLOGICAL SIGNALS AND RECEPTORS = BIOL SIGNAL RECEPT
BIOLOGICAL TRACE ELEMENT RESEARCH = BIOL TRACE ELEM RES
BIOLOGICAL WASTES = BIOL WASTE
BIOLOGICALS = BIOLOGICALS
BIOLOGICHESKIE MEMBRANY = BIOL MEMBRANY
BIOLOGISCHES ZENTRALBLATT = BIOL ZBL
BIOLOGISKE SKRIFTER KONGELIGE DANSKE VIDENSKABERNES SELSKAB = BIOL SKR DAN VID SEL
BIOLOGIST = BIOLOGIST
BIOLOGIYA MORYA-MARINE BIOLOGY = BIOL MORYA-VLAD+
BIOLOGIZACE A CHEMIZACE ZIVOCISNE VYROBY-VETERINARIA = BIOL CHEM ZIVOCISME
BIOLOGY & PHILOSOPHY = BIOL PHILOS
BIOLOGY AND ENVIRONMENT-PROCEEDINGS OF THE ROYAL IRISH ACADEMY = BIOL ENVIRON
BIOLOGY AND FERTILITY OF SOILS = BIOL FERT SOILS
BIOLOGY OF BEHAVIOUR = BIOL BEHAV
BIOLOGY OF METALS = BIOL MET
BIOLOGY OF REPRODUCTION = BIOL REPROD
BIOLOGY OF SPORT = BIOL SPORT
BIOLOGY OF THE CELL = BIOL CELL
BIOLOGY OF THE NEONATE = BIOL NEONATE
BIOMARKERS = BIOMARKERS
BIOMASS = BIOMASS
BIOMASS & BIOENERGY = BIOMASS BIOENERG
BIOMATERIAL-LIVING SYSTEM INTERACTIONS = BIOMATER LIVING SYST
BIOMATERIALS = BIOMATERIALS
BIOMATERIALS ARTIFICIAL CELLS AND ARTIFICIAL ORGANS = BIOMATER ARTIF CELL
BIOMATERIALS ARTIFICIAL CELLS AND IMMOBILIZATION BIOTECHNOLOGY = BIOMAT ARTIF CELL IM
BIOMATERIALS MEDICAL DEVICES AND ARTIFICIAL ORGANS = BIOMATER ARTIF CELL
BIOMEDICA BIOCHIMICA ACTA = BIOMED BIOCHIM ACTA
BIOMEDICAL AND ENVIRONMENTAL MASS SPECTROMETRY = BIOMED ENVIRON MASS
BIOMEDICAL AND ENVIRONMENTAL SCIENCES = BIOMED ENVIRON SCI
BIOMEDICAL CHROMATOGRAPHY = BIOMED CHROMATOGR
BIOMEDICAL ENGINEERING-APPLICATIONS BASIS COMMUNICATIONS = BIOMED ENG-APP BAS C
BIOMEDICAL INSTRUMENTATION & TECHNOLOGY = BIOMED INSTRUM TECHN
BIOMEDICAL LETTERS = BIOMED LETT
BIOMEDICAL MASS SPECTROMETRY = BIOMED MASS SPECTROM
BIOMEDICAL RESEARCH-TOKYO = BIOMED RES-TOKYO
BIOMEDICINE = BIOMEDICINE
BIOMEDICINE & PHARMACOTHERAPY = BIOMED PHARMACOTHER
BIOMEDICINE EXPRESS = BIOMED EXPRESS
BIOMEDIZINISCHE TECHNIK = BIOMED TECH
BIOMEMBRANES = BIOMEMBRANE
BIOMETALS = BIOMETALS
BIOMETRICAL JOURNAL = BIOMETRICAL J
BIOMETRICS = BIOMETRICS
BIOMETRIKA = BIOMETRIKA
BIOMOLECULAR ENGINEERING = BIOMOL ENG
BIOORGANIC & MEDICINAL CHEMISTRY = BIOORGAN MED CHEM
BIOORGANIC & MEDICINAL CHEMISTRY LETTERS = BIOORG MED CHEM LETT
BIOORGANIC CHEMISTRY = BIOORG CHEM
BIOORGANICHESKAYA KHIMIYA = BIOORG KHIM+
BIOPHARM-JOURNAL OF VETERINARY PHARMACY = BIOPHARM-J VET PHARM
BIOPHARM-THE APPLIED TECHNOLOGIES OF BIOPHARMACEUTICAL DEVELOPMENT = BIOPHARM-APPL T BIO
BIOPHARM-THE TECHNOLOGY & BUSINESS OF BIOPHARMACEUTICALS = BIOPHARM-TECHNOL BUS
BIOPHARMACEUTICS & DRUG DISPOSITION = BIOPHARM DRUG DISPOS
BIOPHYSICAL CHEMISTRY = BIOPHYS CHEM
BIOPHYSICAL JOURNAL = BIOPHYS J
BIOPHYSICS OF STRUCTURE AND MECHANISM = BIOPHYS STRUCT MECH
BIOPOLYMERS = BIOPOLYMERS
BIOPROCESS ENGINEERING = BIOPROCESS ENG
BIORECOVERY = BIORECOVERY
BIORESOURCE TECHNOLOGY = BIORESOURCE TECHNOL
BIORHEOLOGY = BIORHEOLOGY
BIOSCIENCE = BIOSCIENCE
BIOSCIENCE BIOTECHNOLOGY AND BIOCHEMISTRY = BIOSCI BIOTECH BIOCH
BIOSCIENCE REPORTS = BIOSCIENCE REP
BIOSENSORS = BIOSENSORS
BIOSENSORS & BIOELECTRONICS = BIOSENS BIOELECTRON
BIOSEPARATION = BIOSEPARATION
BIOSPECTROSCOPY = BIOSPECTROSCOPY
BIOSYSTEMS = BIOSYSTEMS
BIOTECH FORUM EUROPE = BIOTECH FORUM EUROPE
BIOTECHNIC & HISTOCHEMISTRY = BIOTECH HISTOCHEM
BIOTECHNIQUES = BIOTECHNIQUES
BIOTECHNOLOGY & BIOTECHNOLOGICAL EQUIPMENT = BIOTECHNOL BIOTEC EQ
BIOTECHNOLOGY & GENETIC ENGINEERING REVIEWS = BIOTECHNOL GENET ENG
BIOTECHNOLOGY & GENETIC ENGINEERING REVIEWS, VOL 14 = BIOTECHNOL GENET ENG
BIOTECHNOLOGY & GENETIC ENGINEERING REVIEWS, VOL. 15 = BIOTECHNOL GENET ENG
BIOTECHNOLOGY ADVANCES = BIOTECHNOL ADV
BIOTECHNOLOGY AND APPLIED BIOCHEMISTRY = BIOTECHNOL APPL BIOC
BIOTECHNOLOGY AND BIOENGINEERING = BIOTECHNOL BIOENG
BIOTECHNOLOGY AND DEVELOPMENT MONITOR = BIOTECHNOL DEV MONIT
BIOTECHNOLOGY AND GENETIC ENGINEERING REVIEWS, VOL 13 = BIOTECHNOL GENET ENG
BIOTECHNOLOGY AND GENETIC ENGINEERING REVIEWS, VOL 16 = BIOTECHNOL GENET ENG
BIOTECHNOLOGY EDUCATION = BIOTECHNOL EDUC
BIOTECHNOLOGY LAW REPORT = BIOTECHNOL LAW REP
BIOTECHNOLOGY LETTERS = BIOTECHNOL LETT
BIOTECHNOLOGY PROGRESS = BIOTECHNOL PROGR
BIOTECHNOLOGY SOFTWARE & INTERNET JOURNAL = BIOTECHNOL SOFTW I J
BIOTECHNOLOGY SOFTWARE JOURNAL = BIOTECHNOL SOFTW J
BIOTECHNOLOGY TECHNIQUES = BIOTECHNOL TECH
BIOTECHNOLOGY THERAPEUTICS = BIOTECHNOL THER
BIOTELEMETRY AND PATIENT MONITORING = BIOTELEM PAT MON
BIOTHERAPY = BIOTHERAPY
BIOTROPICA = BIOTROPICA
BIOWORLD = BIOWORLD
BIRD BEHAVIOUR = BIRD BEHAV
BIRD CONSERVATION INTERNATIONAL = BIRD CONSERV INT
BIRD STUDY = BIRD STUDY
BIRTH DEFECTS-ORIGINAL ARTICLE SERIES = BIRTH DEFECTS-ORIG
BIRTH-ISSUES IN PERINATAL CARE = BIRTH-ISS PERINAT C
BIT = BIT
BJU INTERNATIONAL = BJU INT
BLACK MUSIC RESEARCH JOURNAL = BLACK MUSIC RES J
BLACK SCHOLAR = BLACK SCHOLAR
BLAKE-AN ILLUSTRATED QUARTERLY = BLAKE-ILLUSTRATED Q
BLOOD = BLOOD
BLOOD CELLS = BLOOD CELLS
BLOOD CELLS MOLECULES AND DISEASES = BLOOD CELL MOL DIS
BLOOD COAGULATION & FIBRINOLYSIS = BLOOD COAGUL FIBRIN
BLOOD PRESSURE = BLOOD PRESSURE
BLOOD PRESSURE MONITORING = BLOOD PRESS MONIT
BLOOD PURIFICATION = BLOOD PURIFICAT
BLOOD REVIEWS = BLOOD REV
BLOOD VESSELS = BLOOD VESSELS
BLUMEA = BLUMEA
BLUT = BLUT
BMR JOURNAL OF AUSTRALIAN GEOLOGY & GEOPHYSICS = BMR J AUST GEOL GEOP
BODENKULTUR = BODENKULTUR
BOLETIN DE LA REAL ACADEMIA ESPANOLA = B REAL ACAD ESPAN
BOLETIN DE LA SOCIEDAD CHILENA DE QUIMICA = BOL SOC CHIL QUIM
BOLETIN DE LA SOCIEDAD ESPANOLA DE CERAMICA Y VIDRIO = BOL SOC ESP CERAM V
BOLETIN DE LA SOCIEDAD MATEMATICA MEXICANA = BOL SOC MAT MEX
BOLLETTINO DELL ISTITUTO SIEROTERAPICO MILANESE = B I SIEROTER MILAN
BOLLETTINO DELLA UNIONE MATEMATICA ITALIANA = B UNIONE MAT ITAL
BOLLETTINO DI ZOOLOGIA = B ZOOL
BONE = BONE
BONE AND MINERAL = BONE MINER
BONE MARROW TRANSPLANTATION = BONE MARROW TRANSPL
BOOK COLLECTOR = BOOK COLLECT
BOREAS = BOREAS
BORGYOGYASZATI ES VENEROLOGIAI SZEMLE = BORGYOGY VENER SZLE
BOSTON UNIVERSITY LAW REVIEW = BOSTON U LAW REV
BOTANICA ACTA = BOT ACTA
BOTANICA HELVETICA = BOT HELV
BOTANICA MARINA = BOT MAR
BOTANICAL BULLETIN OF ACADEMIA SINICA = BOT BULL ACAD SINICA
BOTANICAL GAZETTE = BOT GAZ
BOTANICAL JOURNAL OF THE LINNEAN SOCIETY = BOT J LINN SOC
BOTANICAL MAGAZINE-TOKYO = BOT MAG TOKYO
BOTANICAL REVIEW = BOT REV
BOTANIKAI KOZLEMENYEK-BOTANICAL PUBLICATIONS = BOT KOZL
BOTHALIA = BOTHALIA
BOUNDARY 2-AN INTERNATIONAL JOURNAL OF LITERATURE AND CULTURE = BOUNDARY TWO
BOUNDARY-LAYER METEOROLOGY = BOUND-LAY METEOROL
BRAIN = BRAIN
BRAIN & DEVELOPMENT = BRAIN DEV-JPN
BRAIN AND COGNITION = BRAIN COGNITION
BRAIN AND LANGUAGE = BRAIN LANG
BRAIN BEHAVIOR AND EVOLUTION = BRAIN BEHAV EVOLUT
BRAIN BEHAVIOR AND IMMUNITY = BRAIN BEHAV IMMUN
BRAIN INJURY = BRAIN INJURY
BRAIN PATHOLOGY = BRAIN PATHOL
BRAIN RESEARCH = BRAIN RES
BRAIN RESEARCH BULLETIN = BRAIN RES BULL
BRAIN RESEARCH PROTOCOLS = BRAIN RES PROTOC
BRAIN RESEARCH REVIEWS = BRAIN RES REV
BRAIN TOPOGRAPHY = BRAIN TOPOGR
BRAZILIAN ARCHIVES OF BIOLOGY AND TECHNOLOGY = BRAZ ARCH BIOL TECHN
BRAZILIAN JOURNAL OF CHEMICAL ENGINEERING = BRAZ J CHEM ENG
BRAZILIAN JOURNAL OF GENETICS = BRAZ J GENET
BRAZILIAN JOURNAL OF MEDICAL AND BIOLOGICAL RESEARCH = BRAZ J MED BIOL RES
BRAZILIAN JOURNAL OF PHYSICS = BRAZ J PHYS
BREAST = BREAST
BREAST CANCER RESEARCH AND TREATMENT = BREAST CANCER RES TR
BREEDING SCIENCE = BREEDING SCI
BRENNSTOFF-WARME-KRAFT = BRENNST-WARME-KRAFT
BRIGHAM YOUNG UNIVERSITY STUDIES = BRIGHAM YOUNG U STUD
BRIMLEYANA = BRIMLEYANA
BRITISH ANTARCTIC SURVEY BULLETIN = BRIT ANTARCT SURV B
BRITISH BIRDS = BRIT BIRDS
BRITISH CERAMIC TRANSACTIONS = BRIT CERAM T
BRITISH CERAMIC TRANSACTIONS AND JOURNAL = BRIT CERAM TRANS J
BRITISH CORROSION JOURNAL = BRIT CORROS J
BRITISH DENTAL JOURNAL = BRIT DENT J
BRITISH EDUCATIONAL RESEARCH JOURNAL = BRIT EDUC RES J
BRITISH HEART JOURNAL = BRIT HEART J
BRITISH JOURNAL FOR THE HISTORY OF SCIENCE = BRIT J HIST SCI
BRITISH JOURNAL FOR THE PHILOSOPHY OF SCIENCE = BRIT J PHILOS SCI
BRITISH JOURNAL OF ADDICTION = BRIT J ADDICT
BRITISH JOURNAL OF AESTHETICS = BRIT J AESTHET
BRITISH JOURNAL OF ANAESTHESIA = BRIT J ANAESTH
BRITISH JOURNAL OF AUDIOLOGY = BRIT J AUDIOL
BRITISH JOURNAL OF BIOMEDICAL SCIENCE = BRIT J BIOMED SCI
BRITISH JOURNAL OF CANCER = BRIT J CANCER
BRITISH JOURNAL OF CLINICAL PHARMACOLOGY = BRIT J CLIN PHARMACO
BRITISH JOURNAL OF CLINICAL PRACTICE = BRIT J CLIN PRACT
BRITISH JOURNAL OF CLINICAL PSYCHOLOGY = BRIT J CLIN PSYCHOL
BRITISH JOURNAL OF CRIMINOLOGY = BRIT J CRIMINOL
BRITISH JOURNAL OF DERMATOLOGY = BRIT J DERMATOL
BRITISH JOURNAL OF DEVELOPMENTAL DISABILITIES = BRIT J DEV DISABIL
BRITISH JOURNAL OF DEVELOPMENTAL PSYCHOLOGY = BRIT J DEV PSYCHOL
BRITISH JOURNAL OF DISEASES OF THE CHEST = BRIT J DIS CHEST
BRITISH JOURNAL OF EDUCATIONAL PSYCHOLOGY = BRIT J EDUC PSYCHOL
BRITISH JOURNAL OF EDUCATIONAL STUDIES = BRIT J EDUC STUD
BRITISH JOURNAL OF EDUCATIONAL TECHNOLOGY = BRIT J EDUC TECHNOL
BRITISH JOURNAL OF EXPERIMENTAL PATHOLOGY = BRIT J EXP PATHOL
BRITISH JOURNAL OF FAMILY PLANNING = BRIT J FAM PLAN
BRITISH JOURNAL OF GENERAL PRACTICE = BRIT J GEN PRACT
BRITISH JOURNAL OF GUIDANCE & COUNSELLING = BRIT J GUID COUNS
BRITISH JOURNAL OF HAEMATOLOGY = BRIT J HAEMATOL
BRITISH JOURNAL OF HEALTH PSYCHOLOGY = BRIT J HEALTH PSYCH
BRITISH JOURNAL OF HEALTHCARE COMPUTING & INFORMATION MANAGEMENT = BRIT J HEALTHC COMP
BRITISH JOURNAL OF HERPETOLOGY = BRIT J HERPETOL
BRITISH JOURNAL OF HOSPITAL MEDICINE = BRIT J HOSP MED
BRITISH JOURNAL OF INDUSTRIAL MEDICINE = BRIT J IND MED
BRITISH JOURNAL OF INDUSTRIAL RELATIONS = BRIT J IND RELAT
BRITISH JOURNAL OF MANAGEMENT = BRIT J MANAGE
BRITISH JOURNAL OF MATHEMATICAL & STATISTICAL PSYCHOLOGY = BRIT J MATH STAT PSY
BRITISH JOURNAL OF MEDICAL PSYCHOLOGY = BRIT J MED PSYCHOL
BRITISH JOURNAL OF NEUROSURGERY = BRIT J NEUROSURG
BRITISH JOURNAL OF NON-DESTRUCTIVE TESTING = BRIT J NONDESTR TEST
BRITISH JOURNAL OF NUTRITION = BRIT J NUTR
BRITISH JOURNAL OF OBSTETRICS AND GYNAECOLOGY = BRIT J OBSTET GYNAEC
BRITISH JOURNAL OF OPHTHALMOLOGY = BRIT J OPHTHALMOL
BRITISH JOURNAL OF ORAL & MAXILLOFACIAL SURGERY = BRIT J ORAL MAX SURG
BRITISH JOURNAL OF ORAL SURGERY = BRIT J ORAL SURG
BRITISH JOURNAL OF PHARMACOLOGY = BRIT J PHARMACOL
BRITISH JOURNAL OF PLASTIC SURGERY = BRIT J PLAST SURG
BRITISH JOURNAL OF POLITICAL SCIENCE = BRIT J POLIT SCI
BRITISH JOURNAL OF PSYCHIATRY = BRIT J PSYCHIAT
BRITISH JOURNAL OF PSYCHOLOGY = BRIT J PSYCHOL
BRITISH JOURNAL OF RADIOLOGY = BRIT J RADIOL
BRITISH JOURNAL OF RHEUMATOLOGY = BRIT J RHEUMATOL
BRITISH JOURNAL OF SOCIAL PSYCHOLOGY = BRIT J SOC PSYCHOL
BRITISH JOURNAL OF SOCIAL WORK = BRIT J SOC WORK
BRITISH JOURNAL OF SOCIOLOGY = BRIT J SOCIOL
BRITISH JOURNAL OF SOCIOLOGY OF EDUCATION = BRIT J SOCIOL EDUC
BRITISH JOURNAL OF SPORTS MEDICINE = BRIT J SPORT MED
BRITISH JOURNAL OF SURGERY = BRIT J SURG
BRITISH JOURNAL OF UROLOGY = BRIT J UROL
BRITISH JOURNAL OF VENEREAL DISEASES = BRIT J VENER DIS
BRITISH LIBRARY JOURNAL = BRIT LIBR J
BRITISH MEDICAL BULLETIN = BRIT MED BULL
BRITISH MEDICAL JOURNAL = BRIT MED J
BRITISH PHYCOLOGICAL JOURNAL = BRIT PHYCOL J
BRITISH POLYMER JOURNAL = BRIT POLYM J
BRITISH POULTRY SCIENCE = BRIT POULTRY SCI
BRITISH SUGAR BEET REVIEW = BRIT SUGAR BEET REV
BRITISH TELECOM TECHNOLOGY JOURNAL = BRIT TELECOM TECHNOL
BRITISH TELECOMMUNICATIONS ENGINEERING = BRIT TELECOMMUN ENG
BRITISH VETERINARY JOURNAL = BRIT VET J
BRITTONIA = BRITTONIA
BROOKINGS PAPERS ON ECONOMIC ACTIVITY = BROOKINGS PAP ECO AC
BROWN BOVERI REVIEW = BROWN BOVERI REV
BRYOLOGIST = BRYOLOGIST
BT TECHNOLOGY JOURNAL = BT TECHNOL J
BUFFALO LAW REVIEW = BUFFALO LAW REV
BUILDING AND ENVIRONMENT = BUILD ENVIRON
BUILDING RESEARCH AND INFORMATION = BUILD RES INF
BULGARIAN HISTORICAL REVIEW-REVUE BULGARE D HISTOIRE = BULG HIST REV-REV B
BULLETIN D ECOLOGIE = B ECOL
BULLETIN DE CORRESPONDANCE HELLENIQUE = B CORRESP HELLENIQUE
BULLETIN DE L ACADEMIE NATIONALE DE MEDECINE = B ACAD NAT MED PARIS
BULLETIN DE L ACADEMIE POLONAISE DES SCIENCES-SERIE DES SCIENCES CHIMIQUES = B ACAD POL SCI-CHIM
BULLETIN DE L ACADEMIE POLONAISE DES SCIENCES-SERIE DES SCIENCES DE LA TERRE = B POL ACAD SCI-EARTH
BULLETIN DE L ACADEMIE VETERINAIRE DE FRANCE = B ACAD VET FRANCE
BULLETIN DE L INSTITUT PASTEUR = B I PASTEUR
BULLETIN DE LA CLASSE DES SCIENCES ACADEMIE ROYALE DE BELGIQUE = B CL SCI AC ROY BELG
BULLETIN DE LA SOCIETE BOTANIQUE DE FRANCE-ACTUALITES BOTANIQUES = B SOC BOT FR-ACTUAL
BULLETIN DE LA SOCIETE BOTANIQUE DE FRANCE-LETTRES BOTANIQUES = B SOC BOT FR-LETT
BULLETIN DE LA SOCIETE CHIMIQUE DE FRANCE = B SOC CHIM FR
BULLETIN DE LA SOCIETE CHIMIQUE DE FRANCE PARTIE I-PHYSICOCHIMIE DES SYSTEMES LIQUIDES ELECTROCHIMIE CATALYSE GENIE CHIMIQUE = B SOC CHIM FR I-PHYS
BULLETIN DE LA SOCIETE CHIMIQUE DE FRANCE PARTIE II-CHIMIE MOLECULAIRE ORGANIQUE ET BIOLOGIQUE = B SOC CHIM FR II-CH
BULLETIN DE LA SOCIETE DE PATHOLOGIE EXOTIQUE = B SOC PATHOL EXOT
BULLETIN DE LA SOCIETE GEOLOGIQUE DE FRANCE = B SOC GEOL FR
BULLETIN DE LA SOCIETE MATHEMATIQUE DE FRANCE = B SOC MATH FR
BULLETIN DE LA SOCIETE ROYALE DE BOTANIQUE DE BELGIQUE = B SOC ROY BOT BELG
BULLETIN DE LA SOCIETE ZOOLOGIQUE DE FRANCE = B SOC ZOOL FR
BULLETIN DE LA SOCIETE ZOOLOGIQUE DE FRANCE-EVOLUTION ET ZOOLOGIE = B SOC ZOOL FR
BULLETIN DE MINERALOGIE = B MINERAL
BULLETIN DES CENTRES DE RECHERCHES EXPLORATION-PRODUCTION ELF AQUITAINE = B CENT RECH EXPL
BULLETIN DES SCIENCES MATHEMATIQUES = B SCI MATH
BULLETIN DES SOCIETES CHIMIQUES BELGES = B SOC CHIM BELG
BULLETIN DU CANCER = B CANCER
BULLETIN DU CENTRE DE RECHERCHES ELF EXPLORATION PRODUCTION = BULL CENT RECH ELF E
BULLETIN DU MUSEUM NATIONAL D HISTOIRE NATURELLE-SECTION B ADANSONIA = B MUS NATL HIST NAT
BULLETIN EUROPEEN DE PHYSIOPATHOLOGIE RESPIRATOIRE-CLINICAL RESPIRATORY PHYSIOLOGY = B EUR PHYSIOPATH RES
BULLETIN FRANCAIS DE LA PECHE ET DE LA PISCICULTURE = B FR PECHE PISCIC
BULLETIN GEODESIQUE = B GEOD
BULLETIN HISPANIQUE = B HISPANIQUE
BULLETIN MONUMENTAL = B MONUMENTAL
BULLETIN OF CANADIAN PETROLEUM GEOLOGY = B CAN PETROL GEOL
BULLETIN OF CONCERNED ASIAN SCHOLARS = B CONCERN ASIA SCHOL
BULLETIN OF ELECTROCHEMISTRY = B ELECTROCHEM
BULLETIN OF ENTOMOLOGICAL RESEARCH = B ENTOMOL RES
BULLETIN OF ENVIRONMENTAL CONTAMINATION AND TOXICOLOGY = B ENVIRON CONTAM TOX
BULLETIN OF EQUINE RESEARCH INSTITUTE = B EQUINE RES INST
BULLETIN OF EXPERIMENTAL BIOLOGY AND MEDICINE = B EXP BIOL MED+
BULLETIN OF HISPANIC STUDIES = B HISPANIC STUD
BULLETIN OF INDONESIAN ECONOMIC STUDIES = B INDONES ECON STUD
BULLETIN OF MARINE SCIENCE = B MAR SCI
BULLETIN OF MATERIALS SCIENCE = B MATER SCI
BULLETIN OF MATHEMATICAL BIOLOGY = B MATH BIOL
BULLETIN OF MOLECULAR BIOLOGY AND MEDICINE = B MOL BIOL MED
BULLETIN OF SCIENCE TECHNOLOGY & SOCIETY = B SCI TECHNOL SOC
BULLETIN OF SYMBOLIC LOGIC = B SYMB LOG
BULLETIN OF THE ACADEMY OF SCIENCES OF THE USSR DIVISION OF CHEMICAL SCIENCE = B ACAD SCI USSR CH+
BULLETIN OF THE AMERICAN ACADEMY OF PSYCHIATRY AND THE LAW = B AM ACAD PSYCH LAW
BULLETIN OF THE AMERICAN MATHEMATICAL SOCIETY = B AM MATH SOC
BULLETIN OF THE AMERICAN METEOROLOGICAL SOCIETY = B AM METEOROL SOC
BULLETIN OF THE AMERICAN MUSEUM OF NATURAL HISTORY = B AM MUS NAT HIST
BULLETIN OF THE AMERICAN SCHOOLS OF ORIENTAL RESEARCH = B AM SCH ORIENTAL RE
BULLETIN OF THE AMERICAN SOCIETY FOR INFORMATION SCIENCE = B AM SOC INFORM INF
BULLETIN OF THE AMERICAN SOCIETY OF PAPYROLOGISTS = B AM SOC PAPYROLOGIS
BULLETIN OF THE ASTRONOMICAL INSTITUTES OF CZECHOSLOVAKIA = B ASTRON I CZECH
BULLETIN OF THE ATOMIC SCIENTISTS = B ATOM SCI
BULLETIN OF THE AUSTRALIAN MATHEMATICAL SOCIETY = B AUST MATH SOC
BULLETIN OF THE BELGIAN MATHEMATICAL SOCIETY-SIMON STEVIN = B BELG MATH SOC-SIM
BULLETIN OF THE CHEMICAL SOCIETY OF ETHIOPIA = B CHEM SOC ETHIOPIA
BULLETIN OF THE CHEMICAL SOCIETY OF JAPAN = B CHEM SOC JPN
BULLETIN OF THE CLEVELAND MUSEUM OF ART = B CLEVELAND MUS ART
BULLETIN OF THE COMEDIANTES = B COMEDIANTES
BULLETIN OF THE COUNCIL FOR RESEARCH IN MUSIC EDUCATION = B COUN RES MUSIC ED
BULLETIN OF THE EARTHQUAKE RESEARCH INSTITUTE-UNIVERSITY OF TOKYO = B EARTHQ RES I TOKYO
BULLETIN OF THE EUROPEAN ASSOCIATION OF FISH PATHOLOGISTS = BULL EUR ASSN FISH P
BULLETIN OF THE HISTORY OF MEDICINE = B HIST MED
BULLETIN OF THE HOSPITAL FOR JOINT DISEASES ORTHOPAEDIC INSTITUTE = B HOSP JOINT DIS ORT
BULLETIN OF THE INSTITUTE OF CLASSICAL STUDIES = B I CLASS STUD
BULLETIN OF THE INSTITUTE OF HISTORY AND PHILOLOGY ACADEMIA SINICA = B INST HIST PHILOL
BULLETIN OF THE INSTITUTE OF ZOOLOGY ACADEMIA SINICA = B I ZOOL ACAD SINICA
BULLETIN OF THE JAPAN SOCIETY OF PRECISION ENGINEERING = B JPN SOC PREC ENG
BULLETIN OF THE JAPAN SOCIETY OF PRECISION ENGINEERING = INT J JPN S PREC ENG
BULLETIN OF THE JAPANESE SOCIETY OF SCIENTIFIC FISHERIES = B JPN SOC SCI FISH
BULLETIN OF THE JAPANESE SOCIETY OF SCIENTIFIC FISHERIES = NIPPON SUISAN GAKK
BULLETIN OF THE JOHN RYLANDS UNIVERSITY LIBRARY OF MANCHESTER = B JOHN RYLANDS LIBR
BULLETIN OF THE JSME-JAPAN SOCIETY OF MECHANICAL ENGINEERS = B JSME
BULLETIN OF THE KOREAN CHEMICAL SOCIETY = B KOR CHEM SOC
BULLETIN OF THE LONDON MATHEMATICAL SOCIETY = B LOND MATH SOC
BULLETIN OF THE MEDICAL LIBRARY ASSOCIATION = B MED LIBR ASSOC
BULLETIN OF THE MENNINGER CLINIC = B MENNINGER CLIN
BULLETIN OF THE NEW YORK ACADEMY OF MEDICINE = B NEW YORK ACAD MED
BULLETIN OF THE POLISH ACADEMY OF SCIENCES-CHEMISTRY = B POL ACAD SCI-CHEM
BULLETIN OF THE POLISH ACADEMY OF SCIENCES-EARTH SCIENCES = B POL ACAD SCI-EARTH
BULLETIN OF THE RUSSIAN ACADEMY OF SCIENCES-DIVISION OF CHEMICAL SCIENCE = B RUSS ACAD SCI CH+
BULLETIN OF THE SCHOOL OF ORIENTAL AND AFRICAN STUDIES-UNIVERSITY OF LONDON = B SCH ORIENT AFR ST
BULLETIN OF THE SEISMOLOGICAL SOCIETY OF AMERICA = B SEISMOL SOC AM
BULLETIN OF THE TORREY BOTANICAL CLUB = B TORREY BOT CLUB
BULLETIN OF THE VETERINARY INSTITUTE IN PULAWY = B VET I PULAWY
BULLETIN OF THE WORLD HEALTH ORGANIZATION = B WORLD HEALTH ORGAN
BULLETIN OF VOLCANOLOGY = B VOLCANOL
BULLETIN ON NARCOTICS = B NARCOTICS
BULLETIN ON THE RHEUMATIC DISEASES = B RHEUM DIS
BULLETIN-PHILADELPHIA MUSEUM OF ART = B PHILA MUSEUM ART
BUNSEKI KAGAKU = BUNSEKI KAGAKU
BURLINGTON MAGAZINE = BURLINGTON MAG
BURNS = BURNS
BUSINESS AND COMMERCIAL AVIATION = BUS COMMER AVIAT
BUSINESS HISTORY = BUS HIST
BUSINESS HISTORY REVIEW = BUS HIST REV
BUSINESS LAWYER = BUS LAWYER
BUSINESS SOFTWARE REVIEW = BUS SOFTW REV
BUSINESS WEEK = BUS WEEK
BYRON JOURNAL = BYRON J
BYTE = BYTE
BYZANTINE AND MODERN GREEK STUDIES = BYZANTINE MOD GREEK
BYZANTINISCHE ZEITSCHRIFT = BYZANTINISCHE Z
BYZANTINOSLAVICA = BYZANTINOSLAVICA
