D H LAWRENCE REVIEW = D H LAWRENCE REV
DADOS-REVISTA DE CIENCIAS SOCIAIS = DADOS-REV CIENC SOC
DAEDALUS = DAEDALUS
DAIRY INDUSTRIES INTERNATIONAL = DAIRY IND INT
DALHOUSIE REVIEW = DALHOUSIE REV
DANA-A JOURNAL OF FISHERIES AND MARINE RESEARCH = DANA-J FISH MAR RES
DANCE & DANCERS = DANCE DANCERS
DANCE CHRONICLE = DANCE CHRONICLE
DANCE MAGAZINE = DANCE MAG
DANCE RESEARCH JOURNAL = DANCE RES J
DANCE THEATRE JOURNAL = DANCE THEAT J
DANCING TIMES = DANCING TIMES
DANISH MEDICAL BULLETIN = DAN MED BULL
DAPHNIS-ZEITSCHRIFT FUR MITTLERE DEUTSCHE LITERATUR = DAPHNIS
DATA & KNOWLEDGE ENGINEERING = DATA KNOWL ENG
DATA BASE = DATA BASE
DATA BASE FOR ADVANCES IN INFORMATION SYSTEMS = DATA BASE ADV INF SY
DATA BASE PRODUCT REPORTS = DATA BASE PROD REP
DATA ENTRY AWARENESS REPORTS = DATA ENTRY AWARENESS
DATA MANAGEMENT = DATA MANAGE
DATA MINING AND KNOWLEDGE DISCOVERY = DATA MIN KNOWL DISC
DATA PROCESSING = DATA PROCESS-LONDON
DATABASE = DATABASE
DATABASE-THE MAGAZINE OF ELECTRONIC DATABASE REVIEWS = DATABASE
DATACOMM & DISTRIBUTED PROCESSING REPORT = DATACOMM DISTRIB PR
DATAMATION = DATAMATION
DB-SOUND ENGINEERING MAGAZINE = DB-SOUND ENG MAG
DEAFNESS AND EDUCATION = DEAF EDUC
DEATH STUDIES = DEATH STUD
DECISION SCIENCES = DECISION SCI
DECISION SUPPORT SYSTEMS = DECIS SUPPORT SYST
DEEP-SEA RESEARCH PART A-OCEANOGRAPHIC RESEARCH PAPERS = DEEP-SEA RES
DEEP-SEA RESEARCH PART I-OCEANOGRAPHIC RESEARCH PAPERS = DEEP-SEA RES PT I
DEEP-SEA RESEARCH PART II-TOPICAL STUDIES IN OCEANOGRAPHY = DEEP-SEA RES PT II
DEFECT AND DIFFUSION FORUM = DEFECT DIFFUS FORUM
DEFENCE AND PEACE ECONOMICS = DEFENCE PEACE ECON
DEFENCE SCIENCE JOURNAL = DEFENCE SCI J
DEFENSE OF MUCOSAL SURFACES: PATHOGENESIS, IMMUNITY AND VACCINES = CURR TOP MICROBIOL
DEGRES-REVUE DE SYNTHESE A ORIENTATION SEMIOLOGIQUE = DEGRES
DELAWARE AGRICULTURAL EXPERIMENT STATION BULLETIN = DEL AGR EXP STA BULL
DELAWARE MEDICAL JOURNAL = DEL MED J
DEMENTIA = DEMENTIA
DEMENTIA AND GERIATRIC COGNITIVE DISORDERS = DEMENT GERIATR COGN
DEMOGRAPHY = DEMOGRAPHY
DENKI KAGAKU = DENKI KAGAKU
DENKMALPFLEGE = DENKMALPFLEGE
DENTAL CLINICS OF NORTH AMERICA = DENT CLIN N AM
DENTAL MANAGEMENT = DENT MANAGE
DENTAL MATERIALS = DENT MATER
DENTOMAXILLOFACIAL RADIOLOGY = DENTOMAXILLOFAC RAD
DENVER UNIVERSITY LAW REVIEW = DENVER U LAW REV
DEPRESSION AND ANXIETY = DEPRESS ANXIETY
DERMATOLOGIC CLINICS = DERMATOL CLIN
DERMATOLOGIC SURGERY = DERMATOL SURG
DERMATOLOGICA = DERMATOLOGICA
DERMATOLOGY = DERMATOLOGY
DERMATOSEN IN BERUF UND UMWELT = DERMATOS BER UMWELT
DESALINATION = DESALINATION
DESARROLLO ECONOMICO-REVISTA DE CIENCIAS SOCIALES = DESARROLLO ECON
DESCANT = DESCANT
DESIGN = DESIGN
DESIGN AUTOMATION FOR EMBEDDED SYSTEMS = DES AUTOM EMBED SYST
DESIGN ENGINEERING-LONDON = DES ENG-LONDON
DESIGN ISSUES = DES ISSUES
DESIGN NEWS = DESIGN NEWS
DESIGN QUARTERLY = DESIGN QUART
DESIGNED MONOMERS AND POLYMERS = DES MONOMERS POLYM
DESIGNS CODES AND CRYPTOGRAPHY = DESIGN CODE CRYPTOGR
DEUTSCHE ENTOMOLOGISCHE ZEITSCHRIFT = DEUT ENTOMOL Z
DEUTSCHE GESUNDHEITSWESEN-ZEITSCHRIFT FUR KLINISCHE MEDIZIN = DEUT GESUNDHEITSWES
DEUTSCHE KUNST UND DENKMALPFLEGE = DEUT KUNST DENKMALPF
DEUTSCHE LEBENSMITTEL-RUNDSCHAU = DEUT LEBENSM-RUNDSCH
DEUTSCHE MEDIZINISCHE WOCHENSCHRIFT = DEUT MED WOCHENSCHR
DEUTSCHE SPRACHE = DEUT SPRACHE
DEUTSCHE TIERARZTLICHE WOCHENSCHRIFT = DEUT TIERARZTL WOCH
DEUTSCHE VIERTELJAHRSSCHRIFT FUR LITERATURWISSENSCHAFT UND GEISTESGESCHICHTE = DEUT VIER LIT GEIST
DEUTSCHE ZAHNARZTLICHE ZEITSCHRIFT = DEUT ZAHNAERZTL Z
DEUTSCHE ZEITSCHRIFT FUR PHILOSOPHIE = DEUT Z PHILOS
DEVELOPING ECONOMIES = DEV ECON
DEVELOPMENT = DEVELOPMENT
DEVELOPMENT AND CHANGE = DEV CHANGE
DEVELOPMENT AND PSYCHOPATHOLOGY = DEV PSYCHOPATHOL
DEVELOPMENT GENES AND EVOLUTION = DEV GENES EVOL
DEVELOPMENT GROWTH & DIFFERENTIATION = DEV GROWTH DIFFER
DEVELOPMENT OF SPECIFICATIONS FOR BIOTECHNOLOGY PHARMACEUTICAL PRODUCTS = DEV BIOL STAND
DEVELOPMENT OF THE CEREBRAL CORTEX = CIBA F SYMP
DEVELOPMENTAL AND COMPARATIVE IMMUNOLOGY = DEV COMP IMMUNOL
DEVELOPMENTAL BIOLOGY = DEV BIOL
DEVELOPMENTAL BRAIN DYSFUNCTION = DEV BRAIN DYSFUNCT
DEVELOPMENTAL BRAIN RESEARCH = DEV BRAIN RES
DEVELOPMENTAL DYNAMICS = DEV DYNAM
DEVELOPMENTAL GENETICS = DEV GENET
DEVELOPMENTAL IMMUNOLOGY = DEV IMMUNOL
DEVELOPMENTAL MEDICINE AND CHILD NEUROLOGY = DEV MED CHILD NEUROL
DEVELOPMENTAL NEUROPSYCHOLOGY = DEV NEUROPSYCHOL
DEVELOPMENTAL NEUROSCIENCE = DEV NEUROSCI-BASEL
DEVELOPMENTAL PHARMACOLOGY AND THERAPEUTICS = DEV PHARMACOL THERAP
DEVELOPMENTAL PSYCHOBIOLOGY = DEV PSYCHOBIOL
DEVELOPMENTAL PSYCHOLOGY = DEV PSYCHOL
DEVELOPMENTAL REVIEW = DEV REV
DEVELOPMENTS IN BIOLOGICAL STANDARDIZATION = DEV BIOL STAND
DEVELOPMENTS IN INDUSTRIAL MICROBIOLOGY = DEV IND MICROBIOL
DEVELOPMENTS IN NEUROSCIENCE = DEV NEUROSCI-AMSTER
DEVELOPMENTS IN OPHTHALMOLOGY = DEV OPHTHALMOL
DEVIANT BEHAVIOR = DEVIANT BEHAV
DIABETES = DIABETES
DIABETES & METABOLISM = DIABETES METAB
DIABETES CARE = DIABETES CARE
DIABETES EDUCATOR = DIABETES EDUCATOR
DIABETES NUTRITION & METABOLISM = DIABETES NUTR METAB
DIABETES OBESITY & METABOLISM = DIABETES OBES METAB
DIABETES RESEARCH AND CLINICAL PRACTICE = DIABETES RES CLIN PR
DIABETES RESEARCH CLINICAL AND EXPERIMENTAL = DIABETES RES CLIN EX
DIABETES REVIEWS = DIABETES REV
DIABETES-METABOLISM RESEARCH AND REVIEWS = DIABETES METAB RES
DIABETES-METABOLISM RESEARCH AND REVIEWS = DIABETES-METAB RES
DIABETES-METABOLISM REVIEWS = DIABETES METAB REV
DIABETIC MEDICINE = DIABETIC MED
DIABETOLOGIA = DIABETOLOGIA
DIACRITICS-A REVIEW OF CONTEMPORARY CRITICISM = DIACRITICS
DIAGNOSTIC AND CLINICAL IMMUNOLOGY = DIAGN CLIN IMMUNOL
DIAGNOSTIC CYTOPATHOLOGY = DIAGN CYTOPATHOL
DIAGNOSTIC GYNECOLOGY AND OBSTETRICS = DIAGN GYNECOL OBSTET
DIAGNOSTIC HISTOPATHOLOGY = DIAGN HISTOPATHOL
DIAGNOSTIC IMAGING = DIAGN IMAGING
DIAGNOSTIC IMAGING IN CLINICAL MEDICINE = DIAGN IMAG CLIN MED
DIAGNOSTIC IMMUNOLOGY = DIAGN CLIN IMMUNOL
DIAGNOSTIC MICROBIOLOGY AND INFECTIOUS DISEASE = DIAGN MICR INFEC DIS
DIAGNOSTIC MOLECULAR PATHOLOGY = DIAGN MOL PATHOL
DIAGNOSTIC ONCOLOGY = DIAGN ONCOL
DIAGNOSTICA = DIAGNOSTICA
DIALECTICA = DIALECTICA
DIALECTICAL ANTHROPOLOGY = DIALECT ANTHROPOL
DIALOGUE-CANADIAN PHILOSOPHICAL REVIEW = DIALOGUE-CAN PHILOS
DIALYSIS & TRANSPLANTATION = DIALYSIS TRANSPLANT
DIAMOND AND RELATED MATERIALS = DIAM RELAT MATER
DIAMOND FILMS AND TECHNOLOGY = DIAMOND FILM TECHNOL
DICKENS QUARTERLY = DICKENS QUART
DICKENSIAN = DICKENSIAN
DICP-THE ANNALS OF PHARMACOTHERAPY = DICP ANN PHARMAC
DIE CASTING ENGINEER = DIE CAST ENG
DIECIOCHO-HISPANIC ENLIGHTENMENT = DIECIOCHO
DIESEL PROGRESS ENGINES & DRIVES = DIESEL PROG ENGINE D
DIESEL PROGRESS NORTH AMERICAN EDITION = DIESEL PROG N AM ED
DIFFERENTIAL EQUATIONS = DIFF EQUAT+
DIFFERENTIAL GEOMETRY AND ITS APPLICATIONS = DIFFER GEOM APPL
DIFFERENTIATION = DIFFERENTIATION
DIGESTION = DIGESTION
DIGESTIVE AND LIVER DISEASE = DIGEST LIVER DIS
DIGESTIVE DISEASES = DIGEST DIS
DIGESTIVE DISEASES AND SCIENCES = DIGEST DIS SCI
DIGESTIVE SURGERY = DIGEST SURG
DIGITAL PROCESSES = DIGITAL PROCESS
DIGITAL SIGNAL PROCESSING = DIGIT SIGNAL PROCESS
DIGITALE BILDDIAGNOSTIK = DIGITALE BILDDIAGN
DIOGENES = DIOGENES
DIPLOMATIC HISTORY = DIPLOMATIC HIST
DISABILITY & SOCIETY = DISABIL SOC
DISABILITY AND REHABILITATION = DISABIL REHABIL
DISASTERS = DISASTERS
DISCOURSE & SOCIETY = DISCOURSE SOC
DISCOURSE PROCESSES = DISCOURSE PROCESS
DISCOVER = DISCOVER
DISCOVERY AND INNOVATION = DISCOV INNOVAT
DISCRETE & COMPUTATIONAL GEOMETRY = DISCRETE COMPUT GEOM
DISCRETE AND CONTINUOUS DYNAMICAL SYSTEMS = DISCRET CONTIN DYN S
DISCRETE APPLIED MATHEMATICS = DISCRETE APPL MATH
DISCRETE DYNAMICS IN NATURE AND SOCIETY = DISCRETE DYN NAT SOC
DISCRETE EVENT DYNAMIC SYSTEMS-THEORY AND APPLICATIONS = DISCRETE EVENT DYN S
DISCRETE MATHEMATICS = DISCRETE MATH
DISCUSSIONS IN NEUROSCIENCE = DISCUSS NEUROSCI
DISEASE MANAGEMENT & HEALTH OUTCOMES = DIS MANAG HEALTH OUT
DISEASE MARKERS = DIS MARKERS
DISEASES OF AQUATIC ORGANISMS = DIS AQUAT ORGAN
DISEASES OF THE COLON & RECTUM = DIS COLON RECTUM
DISEASES OF THE ESOPHAGUS = DIS ESOPHAGUS
DISPLAYS = DISPLAYS
DISPUTE RESOLUTION JOURNAL = DISPUTE RESOLUT J
DISSENT = DISSENT
DISTRIBUTED AND PARALLEL DATABASES = DISTRIB PARALLEL DAT
DISTRIBUTED COMPUTING = DISTRIB COMPUT
DISTRIBUTED PROCESSING PRODUCT REPORTS = DISTRIB PROCESS PROD
DIVERSITY = DIVERSITY
DIVERSITY FACTOR = DIVERS FACTOR
DIX-SEPTIEME SIECLE = DIX-SEPTIEME SIECLE
DM DISEASE-A-MONTH = DM-DIS MON
DNA AND CELL BIOLOGY = DNA CELL BIOL
DNA SEQUENCE = DNA SEQUENCE
DNA-A JOURNAL OF MOLECULAR & CELLULAR BIOLOGY = DNA-J MOLEC CELL BIO
DOCUMENT & IMAGE AUTOMATION = DOC IMAGE AUTOM
DOCUMENTA OPHTHALMOLOGICA = DOC OPHTHALMOL
DODO-JOURNAL OF THE WILDLIFE PRESERVATION TRUSTS = DODO
DOKLADI NA BOLGARSKATA AKADEMIYA NA NAUKITE = DOKL BOLG AKAD NAUK
DOKLADY AKADEMII NAUK = DOKL AKAD NAUK+
DOKLADY AKADEMII NAUK BELARUSI = DOKL AKAD NAUK BELAR
DOKLADY AKADEMII NAUK SSSR = DOKL AKAD NAUK SSSR+
DOMESTIC ANIMAL ENDOCRINOLOGY = DOMEST ANIM ENDOCRIN
DOPOVIDI AKADEMII NAUK UKRAINSKOI RSR SERIYA A-FIZIKO-MATEMATICHNI TA TECHNICHNI NAUKI = DOPOV AKAD NAUK A
DOPOVIDI AKADEMII NAUK UKRAINSKOI RSR SERIYA B-GEOLOGICHNI KHIMICHNI TA BIOLOGICHNI NAUKI = DOPOV AKAD NAUK B
DOWN BEAT = DOWN BEAT
DR DOBBS JOURNAL = DR DOBBS J
DREAMING = DREAMING
DREVARSKY VYSKUM = DREV VYSK
DRUG & COSMETIC INDUSTRY = DRUG COSMET IND
DRUG AND ALCOHOL DEPENDENCE = DRUG ALCOHOL DEPEN
DRUG AND ALCOHOL REVIEW = DRUG ALCOHOL REV
DRUG AND CHEMICAL TOXICOLOGY = DRUG CHEM TOXICOL
DRUG DELIVERY = DRUG DELIV
DRUG DEVELOPMENT AND INDUSTRIAL PHARMACY = DRUG DEV IND PHARM
DRUG DEVELOPMENT RESEARCH = DRUG DEVELOP RES
DRUG DISCOVERY TODAY = DRUG DISCOV TODAY
DRUG INFORMATION JOURNAL = DRUG INF J
DRUG INTELLIGENCE & CLINICAL PHARMACY = DRUG INTEL CLIN PHAR
DRUG INVESTIGATION = DRUG INVEST
DRUG METABOLISM AND DISPOSITION = DRUG METAB DISPOS
DRUG METABOLISM REVIEWS = DRUG METAB REV
DRUG NEWS & PERSPECTIVES = DRUG NEWS PERSPECT
DRUG RESISTANCE UPDATES = DRUG RESIST UPDATE
DRUG SAFETY = DRUG SAFETY
DRUG-NUTRIENT INTERACTIONS = DRUG NUTR INTERACT
DRUGS = DRUGS
DRUGS & AGING = DRUG AGING
DRUGS OF TODAY = DRUGS TODAY
DRUGS UNDER EXPERIMENTAL AND CLINICAL RESEARCH = DRUG EXP CLIN RES
DRUGS-EDUCATION PREVENTION AND POLICY = DRUG-EDUC PREV POLIC
DRUSTVENA ISTRAZIVANJA = DRUS ISTRAZ
DRYING TECHNOLOGY = DRY TECHNOL
DU-DIE ZEITSCHRIFT DER KULTUR = DU-Z KULTUR
DUKE LAW JOURNAL = DUKE LAW J
DUKE MATHEMATICAL JOURNAL = DUKE MATH J
DURABILITY OF BUILDING MATERIALS = DURABILITY BUILD MAT
DURHAM UNIVERSITY JOURNAL = DURHAM UNIV J
DYES AND PIGMENTS = DYES PIGMENTS
DYNAMICS AND CONTROL = DYNAM CONTROL
DYNAMICS AND STABILITY OF SYSTEMS = DYNAM STABIL SYST
DYNAMICS OF ATMOSPHERES AND OCEANS = DYNAM ATMOS OCEANS
DYNAMICS OF CONTINUOUS DISCRETE AND IMPULSIVE SYSTEMS = DYN CONTIN DISCRET I
DYNAMISCHE PSYCHIATRIE = DYNAM PSYCHIAT
DYSPHAGIA = DYSPHAGIA
