FABULA = FABULA
FACIES = FACIES
FAMILIES IN SOCIETY-THE JOURNAL OF CONTEMPORARY HUMAN SERVICES = FAM SOC-J CONTEMP H
FAMILY & COMMUNITY HEALTH = FAM COMMUNITY HEALTH
FAMILY LAW QUARTERLY = FAM LAW QUART
FAMILY MEDICINE = FAM MED
FAMILY PLANNING PERSPECTIVES = FAM PLANN PERSPECT
FAMILY PRACTICE = FAM PRACT
FAMILY PROCESS = FAM PROCESS
FAMILY RELATIONS = FAM RELAT
FAO PLANT PROTECTION BULLETIN = FAO PLANT PROTECT B
FARADAY DISCUSSIONS = FARADAY DISCUSS
FARADAY SYMPOSIA OF THE CHEMICAL SOCIETY = FARADAY SYMP CHEM S
FARM BUILDING PROGRESS = FARM BUILD PROGR
FARMACO = FARMACO
FARMACO-EDIZIONE SCIENTIFICA = FARMACO
FARMACO-EDIZIONE SCIENTIFICA = FARMACO-ED SCI
FARMAKOLOGIYA I TOKSIKOLOGIYA = FARMAKOL TOKSIKOL
FASEB JOURNAL = FASEB J
FATIGUE & FRACTURE OF ENGINEERING MATERIALS & STRUCTURES = FATIGUE FRACT ENG M
FATIGUE OF ENGINEERING MATERIALS AND STRUCTURES = FATIGUE ENG MATER
FEBS LETTERS = FEBS LETT
FEDERAL PROBATION = FED PROBAT
FEDERATION PROCEEDINGS = FASEB J
FEDERATION PROCEEDINGS = FED PROC
FELINE PRACTICE = FELINE PRACT
FEMINISM & PSYCHOLOGY = FEM PSYCHOL
FEMINIST ECONOMICS = FEM ECON
FEMINIST REVIEW = FEMINIST REV
FEMINIST STUDIES = FEMINIST STUD
FEMS IMMUNOLOGY AND MEDICAL MICROBIOLOGY = FEMS IMMUNOL MED MIC
FEMS MICROBIOLOGY ECOLOGY = FEMS MICROBIOL ECOL
FEMS MICROBIOLOGY IMMUNOLOGY = FEMS MICROBIOL IMMUN
FEMS MICROBIOLOGY LETTERS = FEMS MICROBIOL LETT
FEMS MICROBIOLOGY REVIEWS = FEMS MICROBIOL REV
FERROELECTRICS = FERROELECTRICS
FERROELECTRICS LETTERS SECTION = FERROELECTRICS LETT
FERTILITY AND STERILITY = FERTIL STERIL
FERTILIZER RESEARCH = FERT RES
FESTKORPERPROBLEME-ADVANCES IN SOLID STATE PHYICS = FESTKOR-ADV SOLID ST
FESTKORPERPROBLEME-ADVANCES IN SOLID STATE PHYSICS = FESTKOR A S
FETAL DIAGNOSIS AND THERAPY = FETAL DIAGN THER
FETT WISSENSCHAFT TECHNOLOGIE-FAT SCIENCE TECHNOLOGY = FETT WISS TECHNOL
FETT-LIPID = FETT-LIPID
FETTE SEIFEN ANSTRICHMITTEL = FETT WISS TECHNOL
FEW-BODY SYSTEMS = FEW-BODY SYST
FF COMMUNICATIONS = FF COMMUN
FIBER AND INTEGRATED OPTICS = FIBER INTEGRATED OPT
FIBONACCI QUARTERLY = FIBONACCI QUART
FIBRE CHEMISTRY = FIBRE CHEM+
FIBRE SCIENCE & TECHNOLOGY = FIBRE SCI TECHNOL
FIBRES & TEXTILES IN EASTERN EUROPE = FIBRES TEXT EAST EUR
FIBRINOLYSIS = FIBRINOLYSIS
FIBRINOLYSIS & PROTEOLYSIS = FIBRINOLYSIS PROTEOL
FIDDLEHEAD = FIDDLEHEAD
FIELD ANALYTICAL CHEMISTRY AND TECHNOLOGY = FIELD ANAL CHEM TECH
FIELD CROPS RESEARCH = FIELD CROP RES
FILM COMMENT = FILM COMMENT
FILM CRITICISM = FILM CRITICISM
FILM QUARTERLY = FILM QUART
FILOSOFIA = FILOSOFIA
FILOSOFICKY CASOPIS = FILOS CAS
FILOZOFIA = FILOZOFIA
FILOZOFSKI VESTNIK-ACTA PHILOSOPHICA = FILOZ VESTN
FILTRATION & SEPARATION = FILTR SEPARAT
FINANCE A UVER = FINANC A UVER
FINANCIAL MANAGEMENT = FINANC MANAGE
FINITE ELEMENTS IN ANALYSIS AND DESIGN = FINITE ELEM ANAL DES
FINITE FIELDS AND THEIR APPLICATIONS = FINITE FIELDS TH APP
FINNISH CHEMICAL LETTERS = FINN CHEM LETT
FIRE AND MATERIALS = FIRE MATER
FIRE COMMAND = FIRE COMMAND
FIRE ENGINEERING = FIRE ENG
FIRE JOURNAL = FIRE J
FIRE SAFETY JOURNAL = FIRE SAFETY J
FIRE SERVICE TODAY = FIRE SERV TODAY
FIRE TECHNOLOGY = FIRE TECHNOL
FISH & SHELLFISH IMMUNOLOGY = FISH SHELLFISH IMMUN
FISH PATHOLOGY = FISH PATHOL
FISH PHYSIOLOGY = FISH PHYSIOL
FISH PHYSIOLOGY AND BIOCHEMISTRY = FISH PHYSIOL BIOCHEM
FISHERIES = FISHERIES
FISHERIES MANAGEMENT = FISH MANAGE
FISHERIES MANAGEMENT AND ECOLOGY = FISHERIES MANAG ECOL
FISHERIES OCEANOGRAPHY = FISH OCEANOGR
FISHERIES RESEARCH = FISH RES
FISHERIES SCIENCE = FISHERIES SCI
FISHERY BULLETIN = FISH B-NOAA
FITOTERAPIA = FITOTERAPIA
FIZIKA METALLOV I METALLOVEDENIE = FIZ MET METALLOVED+
FIZIKA NIZKIKH TEMPERATUR = FIZ NIZK TEMP+
FIZIKA TVERDOGO TELA = FIZ TVERD TELA+
FIZIKA ZEMLI = FIZ ZEMLI+
FIZIOLOGICHESKII ZHURNAL = FIZIOL ZH SSSR
FIZIOLOGIYA I BIOKHIMIYA KULTURNYKH RASTENII = FIZIOL BIOKHIM KULT+
FLAVOUR AND FRAGRANCE JOURNAL = FLAVOUR FRAG J
FLEISCH = FLEISCH
FLEISCHWIRTSCHAFT = FLEISCHWIRTSCHAFT
FLORA = FLORA
FLORIDA ENTOMOLOGIST = FLA ENTOMOL
FLOW MEASUREMENT AND INSTRUMENTATION = FLOW MEAS INSTRUM
FLOW TURBULENCE AND COMBUSTION = FLOW TURBUL COMBUST
FLUID DYNAMICS RESEARCH = FLUID DYN RES
FLUID PHASE EQUILIBRIA = FLUID PHASE EQUILIBR
FLUORIDE = FLUORIDE
FLUSSIGES OBST = FLUSSIGES OBST
FOCUS ON DEPRESSION AND ANXIETY = FOCUS DEPRESS ANX
FOCUS ON EXCEPTIONAL CHILDREN = FOCUS EXCEPT CHILD
FOLDING & DESIGN = FOLD DES
FOLIA BIOLOGICA = FOLIA BIOL-PRAGUE
FOLIA BIOLOGICA-KRAKOW = FOLIA BIOL-KRAKOW
FOLIA GEOBOTANICA = FOLIA GEOBOT
FOLIA GEOBOTANICA & PHYTOTAXONOMICA = FOLIA GEOBOT PHYTOTX
FOLIA HISTOCHEMICA ET CYTOBIOLOGICA = FOLIA HISTOCHEM CYTO
FOLIA HISTOCHEMICA ET CYTOCHEMICA = FOL HISTOCH CYTOCHEM
FOLIA HUMANISTICA = FOLIA HUMANISTICA
FOLIA LINGUISTICA = FOLIA LINGUIST
FOLIA LINGUISTICA HISTORICA = FOLIA LINGUIST HIST
FOLIA MICROBIOLOGICA = FOLIA MICROBIOL
FOLIA NEUROPATHOLOGICA = FOLIA NEUROPATHOL
FOLIA NEUROPSIQUIATRICA = FOLIA NEUROPSIQUIATR
FOLIA PARASITOLOGICA = FOLIA PARASIT
FOLIA PHARMACOLOGICA JAPONICA = FOLIA PHARMACOL JPN
FOLIA PHONIATRICA = FOLIA PHONIATR
FOLIA PHONIATRICA ET LOGOPAEDICA = FOLIA PHONIATR LOGO
FOLIA PRIMATOLOGICA = FOLIA PRIMATOL
FOLIA PSYCHIATRICA ET NEUROLOGICA JAPONICA = FOLIA PSYCHIAT NEU J
FOLIA ZOOLOGICA = FOLIA ZOOL
FOLK LIFE = FOLK LIFE
FOLK MUSIC JOURNAL = FOLK MUSIC J
FOLKLORE = FOLKLORE
FONTES ARTIS MUSICAE = FONTES ARTIS MUSICAE
FOOD ADDITIVES AND CONTAMINANTS = FOOD ADDIT CONTAM
FOOD AND AGRICULTURAL IMMUNOLOGY = FOOD AGR IMMUNOL
FOOD AND AGRICULTURAL IMMUNOLOGY = FOOD AGRIC IMMUNOL
FOOD AND BIOPRODUCTS PROCESSING = FOOD BIOPROD PROCESS
FOOD AND CHEMICAL TOXICOLOGY = FOOD CHEM TOXICOL
FOOD AND COSMETICS TOXICOLOGY = FOOD COSMET TOXICOL
FOOD AND DRUG LAW JOURNAL = FOOD DRUG LAW J
FOOD AUSTRALIA = FOOD AUST
FOOD BIOTECHNOLOGY = FOOD BIOTECHNOL
FOOD CHEMISTRY = FOOD CHEM
FOOD CONTROL = FOOD CONTROL
FOOD ENGINEERING = FOOD ENG
FOOD HYDROCOLLOIDS = FOOD HYDROCOLLOID
FOOD MANUFACTURE = FOOD MANUF
FOOD MICROBIOLOGY = FOOD MICROBIOL
FOOD MICROSTRUCTURE = FOOD MICROSTRUCT
FOOD POLICY = FOOD POLICY
FOOD QUALITY AND PREFERENCE = FOOD QUAL PREFER
FOOD RESEARCH INTERNATIONAL = FOOD RES INT
FOOD REVIEWS INTERNATIONAL = FOOD REV INT
FOOD SCIENCE AND TECHNOLOGY INTERNATIONAL = FOOD SCI TECHNOL INT
FOOD SCIENCE AND TECHNOLOGY-LEBENSMITTEL-WISSENSCHAFT & TECHNOLOGIE = FOOD SCI TECHNOL-LEB
FOOD STRUCTURE = FOOD STRUCT
FOOD TECHNOLOGY = FOOD TECHNOL-CHICAGO
FOOD TECHNOLOGY AND BIOTECHNOLOGY = FOOD TECHNOL BIOTECH
FOOD TECHNOLOGY IN AUSTRALIA = FOOD AUST
FOOD TECHNOLOGY IN AUSTRALIA = FOOD TECHNOL AUST
FOOT & ANKLE = FOOT ANKLE
FOOT & ANKLE INTERNATIONAL = FOOT ANKLE INT
FORBES = FORBES
FORDHAM LAW REVIEW = FORDHAM LAW REV
FOREIGN AFFAIRS = FOREIGN AFF
FOREIGN LANGUAGE ANNALS = FOREIGN LANG ANN
FOREIGN POLICY = FOREIGN POLICY
FORENSIC SCIENCE INTERNATIONAL = FORENSIC SCI INT
FOREST ECOLOGY AND MANAGEMENT = FOREST ECOL MANAG
FOREST PATHOLOGY = FOREST PATHOL
FOREST PRODUCTS JOURNAL = FOREST PROD J
FOREST SCIENCE = FOREST SCI
FORESTRY = FORESTRY
FORESTRY CHRONICLE = FOREST CHRON
FORMAL METHODS IN SYSTEM DESIGN = FORM METHOD SYST DES
FORMULARY = FORMULARY
FORSCHENDE KOMPLEMENTARMEDIZIN = FORSCH KOMPLEMENTMED
FORSCHENDE KOMPLEMENTARMEDIZIN UND KLASSISCHE NATURHEILKUNDE = FORSCH KOMP KLAS NAT
FORSCHUNG IM INGENIEURWESEN-ENGINEERING RESEARCH = FORSCH INGENIEURWES
FORSTWISSENSCHAFTLICHES CENTRALBLATT = FORSTWISS CENTRALBL
FORTSCHRITTE AUF DEM GEBIETE DER RONTGENSTRAHLEN UND DER NEUEN BILDGEBENDEN VERFAHREN = ROFO FORTSCHR RONTG
FORTSCHRITTE AUF DEM GEBIETE DER RONTGENSTRAHLEN UND DER NUKLEARMEDIZIN = FORTSCHR RONTG NEUEN
FORTSCHRITTE DER MEDIZIN = FORTSCHR MED
FORTSCHRITTE DER MINERALOGIE = FORTSCHR MINERAL
FORTSCHRITTE DER NEUROLOGIE PSYCHIATRIE = FORTSCHR NEUROL PSYC
FORTSCHRITTE DER PHYSIK-PROGRESS OF PHYSICS = FORTSCHR PHYS
FORTSCHRITTE DER VETERINARMEDIZIN-ADVANCES IN VETERINARY MEDICINE = FORTSCHR VET
FORTSCHRITTE DER ZOOLOGIE = FORTS ZOOL
FORTUNE = FORTUNE
FORUM DER PSYCHOANALYSE = FORUM PSYCHOANAL
FORUM FOR MODERN LANGUAGE STUDIES = FORUM MOD LANG STUD
FORUM ITALICUM = FORUM ITALICUM
FORUM MATHEMATICUM = FORUM MATH
FORUM MODERNES THEATER = FORUM MOD THEATER
FOUNDATIONS OF PHYSICS = FOUND PHYS
FOUNDATIONS OF PHYSICS LETTERS = FOUND PHYS LETT
FRACTALS-AN INTERDISCIPLINARY JOURNAL ON THE COMPLEX GEOMETRY OF NATURE = FRACTALS
FRACTALS-COMPLEX GEOMETRY PATTERNS AND SCALING IN NATURE AND SOCIETY = FRACTALS
FRANCAIS MODERNE = FRANCAIS MODERN
FREE RADICAL BIOLOGY AND MEDICINE = FREE RADICAL BIO MED
FREE RADICAL RESEARCH = FREE RADICAL RES
FREE RADICAL RESEARCH COMMUNICATIONS = FREE RADICAL RES COM
FREIGHT TRANSPORTATION = TRANSPORT RES REC
FRENCH FORUM = FR FORUM
FRENCH HISTORICAL STUDIES = FR HIST STUD
FRENCH REVIEW = FR REV
FRENCH STUDIES = FR STUD
FREQUENZ = FREQUENZ
FRESENIUS ENVIRONMENTAL BULLETIN = FRESEN ENVIRON BULL
FRESENIUS JOURNAL OF ANALYTICAL CHEMISTRY = FRESEN J ANAL CHEM
FRESENIUS ZEITSCHRIFT FUR ANALYTISCHE CHEMIE = FRESEN Z ANAL CHEM
FRESHWATER BIOLOGY = FRESHWATER BIOL
FRONTIERS IN NEUROENDOCRINOLOGY = FRONT NEUROENDOCRIN
FRONTIERS OF GASTROINTESTINAL RESEARCH = FRONT GASTR RES
FRONTIERS OF HORMONE RESEARCH = FRONT HORM RES
FRONTIERS OF RADIATION THERAPY AND ONCOLOGY = FRONT RADIAT THER ON
FRONTIERS-A JOURNAL OF WOMEN STUDIES = FRONTIERS
FRUIT VARIETIES JOURNAL = FRUIT VARIETIES J
FRUITS = FRUITS
FUEL = FUEL
FUEL PROCESSING TECHNOLOGY = FUEL PROCESS TECHNOL
FUEL SCIENCE & TECHNOLOGY INTERNATIONAL = FUEL SCI TECHN INT
FUJITSU SCIENTIFIC & TECHNICAL JOURNAL = FUJITSU SCI TECH J
FULLERENE SCIENCE AND TECHNOLOGY = FULLERENE SCI TECHN
FUNCTIONAL ANALYSIS AND ITS APPLICATIONS = FUNCT ANAL APPL+
FUNCTIONAL ECOLOGY = FUNCT ECOL
FUNCTIONAL NEUROLOGY = FUNCT NEUROL
FUNDAMENTA MATHEMATICAE = FUND MATH
FUNDAMENTAL & CLINICAL PHARMACOLOGY = FUNDAM CLIN PHARM
FUNDAMENTAL AND APPLIED NEMATOLOGY = FUND APPL NEMATOL
FUNDAMENTAL AND APPLIED TOXICOLOGY = FUND APPL TOXICOL
FUNDAMENTAL AND CLINICAL IMMUNOLOGY = FUND CLIN IMMUNOL
FUNGAL GENETICS AND BIOLOGY = FUNGAL GENET BIOL
FUNKTIONELLE BIOLOGIE & MEDIZIN = FUNKT BIOL MED
FUSION ENGINEERING AND DESIGN = FUSION ENG DES
FUSION TECHNOLOGY = FUSION TECHNOL
FUTURE GENERATION COMPUTER SYSTEMS = FUTURE GENER COMP SY
FUTURE OF CHILDREN = FUTURE CHILD
FUTURES = FUTURES
FUTURIST = FUTURIST
FUZZY SETS AND SYSTEMS = FUZZY SET SYST
