GAIT & POSTURE = GAIT POSTURE
GAMES AND ECONOMIC BEHAVIOR = GAME ECON BEHAV
GAMETE RESEARCH = GAMETE RES
GANN = GANN
GANN MONOGRAPH ON CANCER RESEARCH = GANN MONOGR CANC RES
GARBAGE-THE INDEPENDENT ENVIRONMENTAL QUARTERLY = GARBAGE-INDEP ENV Q
GARTENBAUWISSENSCHAFT = GARTENBAUWISSENSCHAF
GAS ENGINEERING & MANAGEMENT = GAS ENG MANAGE
GAS SEPARATION & PURIFICATION = GAS SEP PURIF
GASTROENTEROLOGIA JAPONICA = GASTROENTEROL JPN
GASTROENTEROLOGIE CLINIQUE ET BIOLOGIQUE = GASTROEN CLIN BIOL
GASTROENTEROLOGY = GASTROENTEROLOGY
GASTROENTEROLOGY CLINICS OF NORTH AMERICA = GASTROENTEROL CLIN N
GASTROINTESTINAL ENDOSCOPY = GASTROINTEST ENDOSC
GASTROINTESTINAL RADIOLOGY = GASTROINTEST RADIOL
GAZETTE MEDICALE = GAZ MED-FRANCE
GAZETTE MEDICALE DE FRANCE = GAZETTE MED FRANCE
GAZZETTA CHIMICA ITALIANA = GAZZ CHIM ITAL
GEBURTSHILFE UND FRAUENHEILKUNDE = GEBURTSH FRAUENHEILK
GEC JOURNAL OF RESEARCH = GEC-J RES
GEC JOURNAL OF TECHNOLOGY = GEC J TECHNOL
GEC REVIEW = GEC REV
GEC-JOURNAL OF SCIENCE & TECHNOLOGY = GEC-J SCI TECHNOL
GEFAHRSTOFFE REINHALTUNG DER LUFT = GEFAHRST REINHALT L
GEGENWARTSKUNDE GESELLSCHAFT STAAT ERZIEHUNG = GEGEN GES STAAT ERZ
GEMATOLOGIYA I TRANSFUZIOLOGIYA = GEMATOL TRANSFUZIOL
GENDER & SOCIETY = GENDER SOC
GENDERS = GENDERS
GENE = GENE
GENE ANALYSIS TECHNIQUES = GENE ANAL TECH
GENE EXPRESSION = GENE EXPRESSION
GENE GEOGRAPHY = GENE GEOGR
GENE THERAPY = GENE THER
GENE-COMBIS = GENE-COMBIS
GENERAL AND COMPARATIVE ENDOCRINOLOGY = GEN COMP ENDOCR
GENERAL HOSPITAL PSYCHIATRY = GEN HOSP PSYCHIAT
GENERAL PHARMACOLOGY = GEN PHARMACOL
GENERAL PHARMACOLOGY-THE VASCULAR SYSTEM = GEN PHARMACOL-VASC S
GENERAL PHYSIOLOGY AND BIOPHYSICS = GEN PHYSIOL BIOPHYS
GENERAL RELATIVITY AND GRAVITATION = GEN RELAT GRAVIT
GENERATIONS-JOURNAL OF THE AMERICAN SOCIETY ON AGING = GENERATIONS
GENES & DEVELOPMENT = GENE DEV
GENES & GENETIC SYSTEMS = GENES GENET SYST
GENES CHROMOSOMES & CANCER = GENE CHROMOSOME CANC
GENES TO CELLS = GENES CELLS
GENETIC ANALYSIS-BIOMOLECULAR ENGINEERING = GENET ANAL-BIOMOL E
GENETIC COUNSELING = GENET COUNSEL
GENETIC ENGINEER & BIOTECHNOLOGIST = GENET ENG BIOTECHNOL
GENETIC ENGINEER AND BIOTECHNOLOGIST = GENET ENG BIOTECHNOL
GENETIC ENGINEERING NEWS = GENET ENG NEWS
GENETIC EPIDEMIOLOGY = GENET EPIDEMIOL
GENETIC RESOURCES AND CROP EVOLUTION = GENET RESOUR CROP EV
GENETIC SOCIAL AND GENERAL PSYCHOLOGY MONOGRAPHS = GENET SOC GEN PSYCH
GENETIC TESTING = GENET TEST
GENETICA = GENETICA
GENETICA POLONICA = GENET POL
GENETICAL RESEARCH = GENET RES
GENETICS = GENETICS
GENETICS AND MOLECULAR BIOLOGY = GENET MOL BIOL
GENETICS IN MEDICINE = GENET MED
GENETICS SELECTION EVOLUTION = GENET SEL EVOL
GENETIKA = GENETIKA+
GENEVA PAPERS ON RISK AND INSURANCE THEORY = GENEVA PAP RISK INS
GENITOURINARY MEDICINE = GENITOURIN MED
GENOME = GENOME
GENOME RESEARCH = GENOME RES
GENOMICS = GENOMICS
GENRE-FORMS OF DISCOURSE AND CULTURE = GENRE-FORM DISC CULT
GEO-MARINE LETTERS = GEO-MAR LETT
GEO-PROCESSING = GEO-PROCESSING
GEOBIOS = GEOBIOS-LYON
GEOCHEMICAL JOURNAL = GEOCHEM J
GEOCHEMISTRY INTERNATIONAL = GEOCHEM INT+
GEOCHIMICA = GEOCHIMICA
GEOCHIMICA ET COSMOCHIMICA ACTA = GEOCHIM COSMOCHIM AC
GEODERMA = GEODERMA
GEODINAMICA ACTA = GEODIN ACTA
GEOEXPLORATION = GEOEXPLORATION
GEOFORUM = GEOFORUM
GEOGRAFISKA ANNALER SERIES A-PHYSICAL GEOGRAPHY = GEOGR ANN A
GEOGRAPHICAL ANALYSIS = GEOGR ANAL
GEOGRAPHICAL JOURNAL = GEOGR J
GEOGRAPHICAL REVIEW = GEOGR REV
GEOGRAPHIE PHYSIQUE ET QUATERNAIRE = GEOGR PHYS QUATERN
GEOGRAPHISCHE ZEITSCHRIFT = GEOGR Z
GEOGRAPHY = GEOGRAPHY
GEOKHIMIYA = GEOKHIMIYA+
GEOLOGICA CARPATHICA = GEOL CARPATH
GEOLOGICAL JOURNAL = GEOL J
GEOLOGICAL MAGAZINE = GEOL MAG
GEOLOGICAL SOCIETY OF AMERICA BULLETIN = GEOL SOC AM BULL
GEOLOGICAL SOCIETY OF AMERICA MEMOIRS = GEOL SOC AM MEM
GEOLOGICAL SURVEY CIRCULAR = GEOL SURV CIRCULAR
GEOLOGICAL SURVEY PROFESSIONAL PAPERS = GEOL SURV PROF PAPER
GEOLOGIE EN MIJNBOUW = GEOL MIJNBOUW
GEOLOGIE EN MIJNBOUW-NETHERLANDS JOURNAL OF GEOSCIENCES = GEOL MIJNBOUW-N J G
GEOLOGISCHE RUNDSCHAU = GEOL RUNDSCH
GEOLOGISKA FORENINGENS I STOCKHOLM FORHANDLINGAR = GEOL FOREN STOCK FOR
GEOLOGIYA I GEOFIZIKA = GEOL GEOFIZ
GEOLOGY = GEOLOGY
GEOLOGY OF ORE DEPOSITS = GEOL ORE DEPOSIT+
GEOMAGNETIZM I AERONOMIYA = GEOMAGN AERON+
GEOMETRIAE DEDICATA = GEOMETRIAE DEDICATA
GEOMETRIC AND FUNCTIONAL ANALYSIS = GEOM FUNCT ANAL
GEOMICROBIOLOGY JOURNAL = GEOMICROBIOL J
GEOMORPHOLOGY = GEOMORPHOLOGY
GEOPHYSICAL AND ASTROPHYSICAL FLUID DYNAMICS = GEOPHYS ASTRO FLUID
GEOPHYSICAL JOURNAL = GEOPHYS J+
GEOPHYSICAL JOURNAL INTERNATIONAL = GEOPHYS J INT
GEOPHYSICAL JOURNAL OF THE ROYAL ASTRONOMICAL SOCIETY = GEOPHYS J INT
GEOPHYSICAL JOURNAL OF THE ROYAL ASTRONOMICAL SOCIETY = GEOPHYS J ROY ASTR S
GEOPHYSICAL JOURNAL-OXFORD = GEOPHYS J INT
GEOPHYSICAL PROSPECTING = GEOPHYS PROSPECT
GEOPHYSICAL RESEARCH LETTERS = GEOPHYS RES LETT
GEOPHYSICAL SURVEYS = GEOPHYS SURV
GEOPHYSICS = GEOPHYSICS
GEORGE WASHINGTON JOURNAL OF INTERNATIONAL LAW AND ECONOMICS = GEORGE WASH J INT L
GEORGE WASHINGTON LAW REVIEW = GEORGE WASH LAW REV
GEORGETOWN LAW JOURNAL = GEORGETOWN LAW J
GEORGIA AGRICULTURAL EXPERIMENT STATION RESEARCH BULLETIN = GEO AGR EXP ST BULL
GEORGIA AGRICULTURAL EXPERIMENT STATION RESEARCH REPORT = GEO AGR EXP ST RE RE
GEORGIA AGRICULTURAL EXPERIMENT STATION SPECIAL PUBLICATION = GEORGIA AES SPEC PUB
GEORGIA AGRICULTURAL RESEARCH = GEORGIA AGR RES
GEORGIA REVIEW = GEORGIA REV
GEOSCIENCE CANADA = GEOSCI CAN
GEOSTANDARDS NEWSLETTER = GEOSTANDARD NEWSLETT
GEOSTANDARDS NEWSLETTER-THE JOURNAL OF GEOSTANDARDS AND GEOANALYSIS = GEOSTANDARD NEWSLETT
GEOSYNTHETICS INTERNATIONAL = GEOSYNTH INT
GEOTECHNICAL TESTING JOURNAL = GEOTECH TEST J
GEOTECHNIQUE = GEOTECHNIQUE
GEOTECTONICS = GEOTECTONICS+
GEOTEXTILES AND GEOMEMBRANES = GEOTEXT GEOMEMBRANES
GEOTHERMICS = GEOTHERMICS
GEOTIMES = GEOTIMES
GERIATRIC CARDIOVASCULAR MEDICINE = GERIATR CARDIOVASC
GERIATRIC NURSING = GERIATR NURS
GERIATRICS = GERIATRICS
GERLANDS BEITRAGE ZUR GEOPHYSIK = GERL BEITR GEOPHYS
GERMAN JOURNAL OF OPHTHALMOLOGY = GER J OPHTHALMOL
GERMAN LIFE AND LETTERS = GER LIFE LETT
GERMAN QUARTERLY = GER QUART
GERMAN STUDIES REVIEW = GER STUD REV
GERMANIC NOTES AND REVIEWS = GER NOTES REV
GERMANIC REVIEW = GER REV
GERMANISCH-ROMANISCHE MONATSSCHRIFT = GER-ROMAN MONATSSCHR
GERMANO-SLAVICA = GERMANO-SLAVICA
GERODONTICS = GERODONTICS
GERODONTOLOGY = GERODONTOLOGY
GERONTOLOGIST = GERONTOLOGIST
GERONTOLOGY = GERONTOLOGY
GESCHICHTE UND GESELLSCHAFT = GESCH GES
GESTA-INTERNATIONAL CENTER OF MEDIEVAL ART = GESTA
GFF = GFF
GI CANCER = GI CANCER
GIFTED CHILD QUARTERLY = GIFTED CHILD QUART
GIORNALE CRITICO DELLA FILOSOFIA ITALIANA = GIORN CRIT FILOS IT
GIORNALE DI GERONTOLOGIA = GIORN GERONTOL
GIORNALE DI NEUROPSICHIATRIA DELL ETA EVOLUTIVA = GIORN NEUROPSI EVOL
GIORNALE DI NEUROPSICOFARMACOLOGIA = GIORN NEUROPSICOFARM
GIORNALE STORICO DELLA LETTERATURA ITALIANA = GIORN STORICO LETT
GLASGOW MATHEMATICAL JOURNAL = GLASGOW MATH J
GLASS AND CERAMICS = GLASS CERAM+
GLASS INDUSTRY = GLASS IND
GLASS PHYSICS AND CHEMISTRY = GLASS PHYS CHEM+
GLASS SCIENCE AND TECHNOLOGY-GLASTECHNISCHE BERICHTE = GLASS SCI TECHNOL
GLASS TECHNOLOGY = GLASS TECHNOL
GLASTECHNISCHE BERICHTE-GLASS SCIENCE AND TECHNOLOGY = GLASTECH BER-GLASS
GLIA = GLIA
GLOBAL AND PLANETARY CHANGE = GLOBAL PLANET CHANGE
GLOBAL BIOGEOCHEMICAL CYCLES = GLOBAL BIOGEOCHEM CY
GLOBAL CHANGE BIOLOGY = GLOB CHANGE BIOL
GLOBAL ECOLOGY AND BIOGEOGRAPHY = GLOBAL ECOL BIOGEOGR
GLOBAL ECOLOGY AND BIOGEOGRAPHY LETTERS = GLOBAL ECOL BIOGEOGR
GLOBAL ENVIRONMENTAL CHANGE-HUMAN AND POLICY DIMENSIONS = GLOBAL ENVIRON CHANG
GLOBAL GOVERNANCE = GLOB GOV
GLOTTA-ZEITSCHRIFT FUR GRIECHISCHE UND LATEINISCHE SPRACHE = GLOTTA
GLQ-A JOURNAL OF LESBIAN AND GAY STUDIES = GLQ-J LESBIAN GAY ST
GLYCOBIOLOGY = GLYCOBIOLOGY
GLYCOCONJUGATE JOURNAL = GLYCOCONJUGATE J
GNOMON-KRITISCHE ZEITSCHRIFT FUR DIE GESAMTE KLASSISCHE ALTERTUMSWISSENSCHAFT = GNOMON
GOETHE JAHRBUCH = GOETHE JAHRB
GOLD BULLETIN = GOLD BULL
GONDWANA RESEARCH = GONDWANA RES
GOVERNANCE-AN INTERNATIONAL JOURNAL OF POLICY AND ADMINISTRATION = GOVERNANCE
GOVERNMENT AND OPPOSITION = GOV OPPOS
GOVERNMENT INFORMATION QUARTERLY = GOV INFORM Q
GOVERNMENT PUBLICATIONS REVIEW = GOV PUBL REV
GOYA = GOYA
GRADIVA = GRADIVA
GRAEFES ARCHIVE FOR CLINICAL AND EXPERIMENTAL OPHTHALMOLOGY = GRAEF ARCH CLIN EXP
GRANA = GRANA
GRANULAR MATTER = GRANUL MATTER
GRAPHICAL MODELS = GRAPH MODELS
GRAPHICAL MODELS AND IMAGE PROCESSING = GRAPH MODEL IM PROC
GRAPHIS = GRAPHIS
GRAPHS AND COMBINATORICS = GRAPH COMBINATOR
GRASAS Y ACEITES = GRASAS ACEITES
GRASS AND FORAGE SCIENCE = GRASS FORAGE SCI
GREAT BASIN NATURALIST = GREAT BASIN NAT
GREAT LAKES ENTOMOLOGIST = GREAT LAKES ENTOMOL
GREAT PLAINS QUARTERLY = GREAT PLAINS QUART
GREECE & ROME = GREECE ROME
GREEK ROMAN AND BYZANTINE STUDIES = GREEK ROMAN BYZANTIN
GREEN CHEMISTRY = GREEN CHEM
GREENHOUSE EFFECT REPORT = GREENHOUSE EFF REP
GROUND ENGINEERING = GROUND ENG
GROUND WATER = GROUND WATER
GROUND WATER MONITORING AND REMEDIATION = GROUND WATER MONIT R
GROUP = GROUP
GROUP & ORGANIZATION MANAGEMENT = GROUP ORGAN MANAGE
GROUP DECISION AND NEGOTIATION = GROUP DECIS NEGOT
GROWTH = GROWTH
GROWTH = GROWTH DEVELOP AGING
GROWTH AND CHANGE = GROWTH CHANGE
GROWTH DEVELOPMENT AND AGING = GROWTH DEVELOP AGING
GROWTH FACTORS = GROWTH FACTORS
GROWTH HORMONE & IGF RESEARCH = GROWTH HORM IGF RES
GROWTH REGULATION = GROWTH REGULAT
GRUPPENDYNAMIK-ZEITSCHRIFT FUR ANGEWANDTE SOZIALPSYCHOLOGIE = GRUPPENDYNAMIK
GRUPPENPSYCHOTHERAPIE UND GRUPPENDYNAMIK = GRUPPENPSYCHOTHER GR
GUERRES MONDIALES ET CONFLITS CONTEMPORAINS = GUERRE MOND CONF CON
GULF RESEARCH REPORTS = GULF RES REP
GUMMI ASBEST KUNSTSTOFFE = GUMMI FASERN KUNSTST
GUMMI FASERN KUNSTSTOFFE = GUMMI FASERN KUNSTST
GUT = GUT
GYMNASIUM = GYMNASIUM
GYNAECOLOGICAL ENDOSCOPY = GYNAECOL ENDOSC
GYNAKOLOGE = GYNAKOLOGE
GYNAKOLOGISCH-GEBURTSHILFLICHE RUNDSCHAU = GYNAKOL GEBURT RUNDS
GYNECOLOGIC AND OBSTETRIC INVESTIGATION = GYNECOL OBSTET INVES
GYNECOLOGIC ONCOLOGY = GYNECOL ONCOL
GYNECOLOGICAL ENDOCRINOLOGY = GYNECOL ENDOCRINOL
