JADERNA ENERGIE = JAD ENERG
JAHRBUCH DER BERLINER MUSEEN = JAHRB BERLIN MUSEEN
JAHRBUCH FUR INTERNATIONALE GERMANISTIK = JAHRB INT GERMAN
JAHRBUCH FUR SOZIALWISSENSCHAFT = JAHRB SOZIALWISSENSC
JAHRBUCH FUR VOLKSLIEDFORSCHUNG = JAHRB VOLKSLIEDFORSC
JAHRBUCHER FUR GESCHICHTE OSTEUROPAS = JAHRB GESCH OSTEUR
JAHRBUCHER FUR NATIONALOKONOMIE UND STATISTIK = JAHRB NATL STAT
JAMA-JOURNAL OF THE AMERICAN MEDICAL ASSOCIATION = JAMA-J AM MED ASSOC
JAMES JOYCE QUARTERLY = JAMES JOYCE QUART
JAPAN AND THE WORLD ECONOMY = JPN WORLD ECON
JAPAN ANNUAL REVIEWS IN ELECTRONICS COMPUTERS & TELECOMMUNICATIONS = JPN ANNU REV ELECTR
JAPAN ARCHITECT = JPN ARCHIT
JAPAN JOURNAL OF INDUSTRIAL AND APPLIED MATHEMATICS = JPN J IND APPL MATH
JAPAN QUARTERLY = JPN QUART
JAPAN TELECOMMUNICATIONS REVIEW = JPN TELECOMMUN REV
JAPANESE CIRCULATION JOURNAL-ENGLISH EDITION = JPN CIRC J
JAPANESE ECONOMIC REVIEW = JPN ECON REV
JAPANESE ECONOMIC STUDIES = JPN ECON STUD
JAPANESE ECONOMY = JPN ECON
JAPANESE HEART JOURNAL = JPN HEART J
JAPANESE JOURNAL OF APPLIED ENTOMOLOGY AND ZOOLOGY = JPN J APPL ENTOMOL Z
JAPANESE JOURNAL OF APPLIED PHYSICS = JPN J APPL PHYS
JAPANESE JOURNAL OF APPLIED PHYSICS PART 1-REGULAR PAPERS SHORT NOTES & REVIEW PAPERS = JPN J APPL PHYS 1
JAPANESE JOURNAL OF APPLIED PHYSICS PART 2-LETTERS = JPN J APPL PHYS 2
JAPANESE JOURNAL OF BREEDING = JPN J BREED
JAPANESE JOURNAL OF CANCER RESEARCH = JPN J CANCER RES
JAPANESE JOURNAL OF CLINICAL ONCOLOGY = JPN J CLIN ONCOL
JAPANESE JOURNAL OF CROP SCIENCE = JPN J CROP SCI
JAPANESE JOURNAL OF EDUCATIONAL PSYCHOLOGY = JPN J EDUC PSYCHOL
JAPANESE JOURNAL OF EXPERIMENTAL MEDICINE = JPN J EXP MED
JAPANESE JOURNAL OF GENETICS = JPN J GENET
JAPANESE JOURNAL OF HUMAN GENETICS = JPN J HUM GENET
JAPANESE JOURNAL OF ICHTHYOLOGY = JPN J ICHTHYOL
JAPANESE JOURNAL OF INFECTIOUS DISEASES = JPN J INFECT DIS
JAPANESE JOURNAL OF MEDICAL SCIENCE & BIOLOGY = JPN J MED SCI BIOL
JAPANESE JOURNAL OF MEDICINE = JPN J MED
JAPANESE JOURNAL OF NEUROPSYCHOPHARMACOLOGY = JPN J NEUROPSYCHOPH
JAPANESE JOURNAL OF OPHTHALMOLOGY = JPN J OPHTHALMOL
JAPANESE JOURNAL OF PHARMACOLOGY = JPN J PHARMACOL
JAPANESE JOURNAL OF PHYSICAL FITNESS AND SPORTS MEDICINE = JPN J PHYS FIT SPORT
JAPANESE JOURNAL OF PHYSIOLOGY = JPN J PHYSIOL
JAPANESE JOURNAL OF PSYCHIATRY AND NEUROLOGY = JPN J PSYCHIAT NEUR
JAPANESE JOURNAL OF PSYCHOLOGY = JPN J PSYCHOL
JAPANESE JOURNAL OF SURGERY = JPN J SURG
JAPANESE JOURNAL OF TOXICOLOGY AND ENVIRONMENTAL HEALTH = JPN J TOX ENV HEALTH
JAPANESE JOURNAL OF TRANSPLANTATION = JPN J TRANSPLANT
JAPANESE JOURNAL OF TROPICAL AGRICULTURE = JPN J TROP AGR
JAPANESE JOURNAL OF VETERINARY RESEARCH = JPN J VET RES
JAPANESE JOURNAL OF VETERINARY SCIENCE = JPN J VET SCI
JAPANESE PSYCHOLOGICAL RESEARCH = JPN PSYCHOL RES
JAPCA-THE INTERNATIONAL JOURNAL OF AIR POLLUTION CONTROL AND HAZARDOUS WASTE MANAGEMENT = JAPCA J AIR WASTE MA
JAPCA-THE JOURNAL OF THE AIR & WASTE MANAGEMENT ASSOCIATION = JAPCA J AIR WASTE MA
JARQ-JAPAN AGRICULTURAL RESEARCH QUARTERLY = JARQ-JPN AGR RES Q
JAVNOST-THE PUBLIC = JAVNOST-PUBLIC
JCR-JOURNAL OF CLINICAL RHEUMATOLOGY = JCR-J CLIN RHEUMATOL
JETP LETTERS = JETP LETT+
JEWISH ART = JEWISH ART
JEWISH JOURNAL OF SOCIOLOGY = JEWISH J SOCIOL
JEWISH QUARTERLY REVIEW = JEWISH QUART REV
JKA-JERNKONTORETS ANNALER = JKA-JERNKONTORET ANN
JMRI-JOURNAL OF MAGNETIC RESONANCE IMAGING = JMRI-J MAGN RESON IM
JNMS-JOURNAL OF THE NEUROMUSCULOSKELETAL SYSTEM = JNMS-J NEUROMUSC SYS
JNT-JOURNAL OF NARRATIVE THEORY = J NARRATIVE THEORY
JOCCA-SURFACE COATINGS INTERNATIONAL = JOCCA-SURF COAT INT
JOHNS HOPKINS APL TECHNICAL DIGEST = J HOPKINS APL TECH D
JOHNS HOPKINS MEDICAL JOURNAL = JOHNS HOPKINS MED J
JOINT BONE SPINE = JOINT BONE SPINE
JOINT COMMISSION JOURNAL ON QUALITY IMPROVEMENT = JOINT COMM J QUAL IM
JOM-JOURNAL OF THE MINERALS METALS & MATERIALS SOCIETY = JOM-J MIN MET MAT S
JOURNAL AMERICAN POMOLOGICAL SOCIETY = J AMER POMOLOG SOC
JOURNAL AMERICAN WATER WORKS ASSOCIATION = J AM WATER WORKS ASS
JOURNAL BELGE DE RADIOLOGIE = J BELG RADIOL
JOURNAL D ANALYSE MATHEMATIQUE = J ANAL MATH
JOURNAL D UROLOGIE = J UROLOGIE
JOURNAL DE BIOLOGIE BUCCALE = J BIOL BUCCALE
JOURNAL DE BIOPHYSIQUE & MEDECINE NUCLEAIRE = J BIOPHYS BIOMEC
JOURNAL DE BIOPHYSIQUE ET DE BIOMECANIQUE = J BIOPHYS BIOMEC
JOURNAL DE CHIMIE PHYSIQUE ET DE PHYSICO-CHIMIE BIOLOGIQUE = J CHIM PHYS PCB
JOURNAL DE CHIRURGIE = J CHIR-PARIS
JOURNAL DE GENETIQUE HUMAINE = J GENET HUM
JOURNAL DE GYNECOLOGIE OBSTETRIQUE ET BIOLOGIE DE LA REPRODUCTION = J GYNECOL OBST BIO R
JOURNAL DE MATHEMATIQUES PURES ET APPLIQUEES = J MATH PURE APPL
JOURNAL DE MECANIQUE = J MECANIQUE
JOURNAL DE MECANIQUE APPLIQUEE = J MEC APPL
JOURNAL DE MECANIQUE THEORIQUE ET APPLIQUEE = J MEC THEOR APPL
JOURNAL DE MEDECINE DE STRASBOURG = J MED STRASBOURG
JOURNAL DE MEDECINE LEGALE DROIT MEDICAL = J MED LEG DROIT MED
JOURNAL DE MEDECINE NUCLEAIRE ET BIOPHYSIQUE = J MED NUCL BIOPHYS
JOURNAL DE MICROSCOPIE ET DE SPECTROSCOPIE ELECTRONIQUES = J MICROSC SPECT ELEC
JOURNAL DE MYCOLOGIE MEDICALE = J MYCOL MED
JOURNAL DE PHARMACIE DE BELGIQUE = J PHARM BELG
JOURNAL DE PHARMACOLOGIE = J PHARMACOL-PARIS
JOURNAL DE PHYSIOLOGIE = J PHYSIOL-PARIS
JOURNAL DE PHYSIQUE = J PHYS-PARIS
JOURNAL DE PHYSIQUE I = J PHYS I
JOURNAL DE PHYSIQUE II = J PHYS II
JOURNAL DE PHYSIQUE II = J PHYS IV
JOURNAL DE PHYSIQUE III = J PHYS III
JOURNAL DE PHYSIQUE III = J PHYS IV
JOURNAL DE PHYSIQUE IV = J PHYS IV
JOURNAL DE PHYSIQUE LETTRES = J PHYS LETT-PARIS
JOURNAL DE RADIOLOGIE = J RADIOL
JOURNAL DE TOXICOLOGIE CLINIQUE ET EXPERIMENTALE = J TOXICOL CLIN EXPER
JOURNAL DE TOXICOLOGIE MEDICALE = J TOXICOL CLIN EXPER
JOURNAL DES MALADIES VASCULAIRES = J MAL VASCUL
JOURNAL DU CONSEIL = J CONSEIL
JOURNAL EUROPEEN DE RADIOTHERAPIE = J EUR RADIOTHER
JOURNAL FOR RESEARCH IN MATHEMATICS EDUCATION = J RES MATH EDUC
JOURNAL FOR THE EDUCATION OF THE GIFTED = J EDUC GIFTED
JOURNAL FOR THE SCIENTIFIC STUDY OF RELIGION = J SCI STUD RELIG
JOURNAL FOR THE THEORY OF SOCIAL BEHAVIOUR = J THEOR SOC BEHAV
JOURNAL FRANCAIS D OPHTALMOLOGIE = J FR OPHTALMOL
JOURNAL FRANCAIS D OTO-RHINO-LARYNGOLOGIE = J FR OTORHINOLARYNG
JOURNAL FUR DIE REINE UND ANGEWANDTE MATHEMATIK = J REINE ANGEW MATH
JOURNAL FUR HIRNFORSCHUNG = J HIRNFORSCH
JOURNAL FUR ORNITHOLOGIE = J ORNITHOL
JOURNAL FUR PRAKTISCHE CHEMIE = J PRAKT CHEM
JOURNAL FUR PRAKTISCHE CHEMIE-CHEMIKER-ZEITUNG = J PRAK CHEM-CHEM ZTG
JOURNAL FUR SIGNALAUFZEICHNUNGSMATERIALIEN = J INFORM REC MATER
JOURNAL OF AAPOS = J AAPOS
JOURNAL OF ABNORMAL CHILD PSYCHOLOGY = J ABNORM CHILD PSYCH
JOURNAL OF ABNORMAL PSYCHOLOGY = J ABNORM PSYCHOL
JOURNAL OF ACADEMIC LIBRARIANSHIP = J ACAD LIBR
JOURNAL OF ACCIDENT & EMERGENCY MEDICINE = J ACCID EMERG MED
JOURNAL OF ACCOUNTANCY = J ACCOUNTANCY
JOURNAL OF ACCOUNTING & ECONOMICS = J ACCOUNT ECON
JOURNAL OF ACCOUNTING AND PUBLIC POLICY = J ACCOUNT PUBLIC POL
JOURNAL OF ACCOUNTING RESEARCH = J ACCOUNTING RES
JOURNAL OF ACQUIRED IMMUNE DEFICIENCY SYNDROMES = J ACQ IMMUN DEF SYND
JOURNAL OF ACQUIRED IMMUNE DEFICIENCY SYNDROMES AND HUMAN RETROVIROLOGY = J ACQ IMMUN DEF SYND
JOURNAL OF ADDICTIVE DISEASES = J ADDICT DIS
JOURNAL OF ADHESION = J ADHESION
JOURNAL OF ADHESION SCIENCE AND TECHNOLOGY = J ADHES SCI TECHNOL
JOURNAL OF ADOLESCENCE = J ADOLESCENCE
JOURNAL OF ADOLESCENT & ADULT LITERACY = J ADOLESC ADULT LIT
JOURNAL OF ADOLESCENT HEALTH = J ADOLESCENT HEALTH
JOURNAL OF ADOLESCENT RESEARCH = J ADOLESCENT RES
JOURNAL OF ADULT DEVELOPMENT = J ADULT DEV
JOURNAL OF ADVANCED MATERIALS = J ADV MATER
JOURNAL OF ADVANCED NURSING = J ADV NURS
JOURNAL OF ADVANCED TRANSPORTATION = J ADV TRANSPORT
JOURNAL OF ADVANCED ZOOLOGY = J ADV ZOOL
JOURNAL OF ADVERTISING = J ADVERTISING
JOURNAL OF ADVERTISING RESEARCH = J ADVERTISING RES
JOURNAL OF AEROSOL MEDICINE-DEPOSITION CLEARANCE AND EFFECTS IN THE LUNG = J AEROSOL MED
JOURNAL OF AEROSOL SCIENCE = J AEROSOL SCI
JOURNAL OF AEROSPACE ENGINEERING = J AEROSPACE ENG
JOURNAL OF AESTHETIC EDUCATION = J AESTHET EDUC
JOURNAL OF AESTHETICS AND ART CRITICISM = J AESTHET ART CRITIC
JOURNAL OF AFFECTIVE DISORDERS = J AFFECT DISORDERS
JOURNAL OF AFRICAN EARTH SCIENCES = J AFR EARTH SCI
JOURNAL OF AFRICAN ECONOMIES = J AFR ECON
JOURNAL OF AFRICAN HISTORY = J AFR HIST
JOURNAL OF AGING AND HEALTH = J AGING HEALTH
JOURNAL OF AGING AND PHYSICAL ACTIVITY = J AGING PHYS ACTIV
JOURNAL OF AGING STUDIES = J AGING STUD
JOURNAL OF AGRICULTURAL & ENVIRONMENTAL ETHICS = J AGR ENVIRON ETHIC
JOURNAL OF AGRICULTURAL AND FOOD CHEMISTRY = J AGR FOOD CHEM
JOURNAL OF AGRICULTURAL AND RESOURCE ECONOMICS = J AGR RESOUR ECON
JOURNAL OF AGRICULTURAL AND URBAN ENTOMOLOGY = J AGR URBAN ENTOMOL
JOURNAL OF AGRICULTURAL BIOLOGICAL AND ENVIRONMENTAL STATISTICS = J AGRIC BIOL ENVIR S
JOURNAL OF AGRICULTURAL ECONOMICS = J AGR ECON
JOURNAL OF AGRICULTURAL ECONOMICS RESEARCH = J AGR ECON RES
JOURNAL OF AGRICULTURAL ENGINEERING RESEARCH = J AGR ENG RES
JOURNAL OF AGRICULTURAL ENTOMOLOGY = J AGR ENTOMOL
JOURNAL OF AGRICULTURAL SCIENCE = J AGR SCI
JOURNAL OF AGRICULTURAL SCIENCE IN FINLAND = J AGR SCI FINLAND
JOURNAL OF AGRICULTURE OF THE UNIVERSITY OF PUERTO RICO = J AGR U PUERTO RICO
JOURNAL OF AGRONOMY AND CROP SCIENCE-ZEITSCHRIFT FUR ACKER UND PFLANZENBAU = J AGRON CROP SCI
JOURNAL OF AIRCRAFT = J AIRCRAFT
JOURNAL OF ALCOHOL AND DRUG EDUCATION = J ALCOHOL DRUG EDUC
JOURNAL OF ALGEBRA = J ALGEBRA
JOURNAL OF ALGEBRAIC COMBINATORICS = J ALGEBR COMB
JOURNAL OF ALGEBRAIC GEOMETRY = J ALGEBRAIC GEOM
JOURNAL OF ALGORITHMS = J ALGORITHM
JOURNAL OF ALLERGY AND CLINICAL IMMUNOLOGY = J ALLERGY CLIN IMMUN
JOURNAL OF ALLOYS AND COMPOUNDS = J ALLOY COMPD
JOURNAL OF ALTERNATIVE AND COMPLEMENTARY MEDICINE = J ALTERN COMPLEM MED
JOURNAL OF AMERICAN COLLEGE HEALTH = J AM COLL HEALTH
JOURNAL OF AMERICAN CULTURE = J AM CULTURE
JOURNAL OF AMERICAN ETHNIC HISTORY = J AM ETHNIC HIST
JOURNAL OF AMERICAN FOLKLORE = J AM FOLKLORE
JOURNAL OF AMERICAN HEALTH CARE = J AM HEALTH CARE
JOURNAL OF AMERICAN HEALTH POLICY = J AM HEALTH POLICY
JOURNAL OF AMERICAN HISTORY = J AM HIST
JOURNAL OF AMERICAN STUDIES = J AM STUD
JOURNAL OF ANALYTICAL AND APPLIED PYROLYSIS = J ANAL APPL PYROL
JOURNAL OF ANALYTICAL ATOMIC SPECTROMETRY = J ANAL ATOM SPECTROM
JOURNAL OF ANALYTICAL CHEMISTRY = J ANAL CHEM+
JOURNAL OF ANALYTICAL CHEMISTRY OF THE USSR = J ANAL CHEM-USSR+
JOURNAL OF ANALYTICAL PSYCHOLOGY = J ANAL PSYCHOL
JOURNAL OF ANALYTICAL TOXICOLOGY = J ANAL TOXICOL
JOURNAL OF ANATOMY = J ANAT
JOURNAL OF ANDROLOGY = J ANDROL
JOURNAL OF ANIMAL AND FEED SCIENCES = J ANIM FEED SCI
JOURNAL OF ANIMAL BREEDING AND GENETICS-ZEITSCHRIFT FUR TIERZUCHTUNG UND ZUCHTUNGSBIOLOGIE = J ANIM BREED GENET
JOURNAL OF ANIMAL ECOLOGY = J ANIM ECOL
JOURNAL OF ANIMAL PHYSIOLOGY AND ANIMAL NUTRITION-ZEITSCHRIFT FUR TIERPHYSIOLOGIE TIERERNAHRUNG UND FUTTERMITTELKUNDE = J ANIM PHYSIOL AN N
JOURNAL OF ANIMAL SCIENCE = J ANIM SCI
JOURNAL OF ANTHROPOLOGICAL ARCHAEOLOGY = J ANTHROPOL ARCHAEOL
JOURNAL OF ANTHROPOLOGICAL RESEARCH = J ANTHROPOL RES
JOURNAL OF ANTIBIOTICS = J ANTIBIOT
JOURNAL OF ANTIMICROBIAL CHEMOTHERAPY = J ANTIMICROB CHEMOTH
JOURNAL OF ANXIETY DISORDERS = J ANXIETY DISORD
JOURNAL OF AOAC INTERNATIONAL = J AOAC INT
JOURNAL OF APICULTURAL RESEARCH = J APICULT RES
JOURNAL OF APPLIED ANIMAL RESEARCH = J APPL ANIM RES
JOURNAL OF APPLIED BACTERIOLOGY = J APPL BACTERIOL
JOURNAL OF APPLIED BEHAVIOR ANALYSIS = J APPL BEHAV ANAL
JOURNAL OF APPLIED BIOMATERIALS = J APPL BIOMATER
JOURNAL OF APPLIED BIOMECHANICS = J APPL BIOMECH
JOURNAL OF APPLIED BOTANY-ANGEWANDTE BOTANIK = J APPL BOT-ANGEW BOT
JOURNAL OF APPLIED CARDIOLOGY = J APPL CARDIOL
JOURNAL OF APPLIED CHEMISTRY OF THE USSR = J APPL CHEM-USSR+
JOURNAL OF APPLIED COMMUNICATION RESEARCH = J APPL COMMUN RES
JOURNAL OF APPLIED CRYSTALLOGRAPHY = J APPL CRYSTALLOGR
JOURNAL OF APPLIED DEVELOPMENTAL PSYCHOLOGY = J APPL DEV PSYCHOL
JOURNAL OF APPLIED ECOLOGY = J APPL ECOL
JOURNAL OF APPLIED ECONOMETRICS = J APPL ECONOM
JOURNAL OF APPLIED ELECTROCHEMISTRY = J APPL ELECTROCHEM
JOURNAL OF APPLIED ENTOMOLOGY-ZEITSCHRIFT FUR ANGEWANDTE ENTOMOLOGIE = J APPL ENTOMOL
JOURNAL OF APPLIED GEOPHYSICS = J APPL GEOPHYS
JOURNAL OF APPLIED GERONTOLOGY = J APPL GERONTOL
JOURNAL OF APPLIED ICHTHYOLOGY-ZEITSCHRIFT FUR ANGEWANDTE ICHTHYOLOGIE = J APPL ICHTHYOL
JOURNAL OF APPLIED MECHANICS-TRANSACTIONS OF THE ASME = J APPL MECH-T ASME
JOURNAL OF APPLIED METEOROLOGY = J APPL METEOROL
JOURNAL OF APPLIED MICROBIOLOGY = J APPL MICROBIOL
JOURNAL OF APPLIED PHOTOGRAPHIC ENGINEERING = J APPL PHOTOGR ENG
JOURNAL OF APPLIED PHYCOLOGY = J APPL PHYCOL
JOURNAL OF APPLIED PHYSICS = J APPL PHYS
JOURNAL OF APPLIED PHYSIOLOGY = J APPL PHYSIOL
JOURNAL OF APPLIED POLYMER SCIENCE = J APPL POLYM SCI
JOURNAL OF APPLIED POULTRY RESEARCH = J APPL POULTRY RES
JOURNAL OF APPLIED PROBABILITY = J APPL PROBAB
JOURNAL OF APPLIED PSYCHOLOGY = J APPL PSYCHOL
JOURNAL OF APPLIED RESEARCH IN INTELLECTUAL DISABILITIES = J APPL RES INTELLECT
JOURNAL OF APPLIED SOCIAL PSYCHOLOGY = J APPL SOC PSYCHOL
JOURNAL OF APPLIED SPORT PSYCHOLOGY = J APPL SPORT PSYCHOL
JOURNAL OF APPLIED STATISTICS = J APPL STAT
JOURNAL OF APPLIED TOXICOLOGY = J APPL TOXICOL
JOURNAL OF APPROXIMATION THEORY = J APPROX THEORY
JOURNAL OF AQUATIC ANIMAL HEALTH = J AQUAT ANIM HEALTH
JOURNAL OF AQUATIC PLANT MANAGEMENT = J AQUAT PLANT MANAGE
JOURNAL OF ARAB AFFAIRS = J ARAB AFF
JOURNAL OF ARABIC LITERATURE = J ARABIC LIT
JOURNAL OF ARACHNOLOGY = J ARACHNOL
JOURNAL OF ARCHAEOLOGICAL METHOD AND THEORY = J ARCHAEOL METHOD TH
JOURNAL OF ARCHAEOLOGICAL RESEARCH = J ARCHAEOL RES
JOURNAL OF ARCHAEOLOGICAL SCIENCE = J ARCHAEOL SCI
JOURNAL OF ARCHITECTURAL AND PLANNING RESEARCH = J ARCHIT PLAN RES
JOURNAL OF ARCHITECTURAL EDUCATION = J ARCHIT EDUC
JOURNAL OF ARID ENVIRONMENTS = J ARID ENVIRON
JOURNAL OF ART & DESIGN EDUCATION = J ART DESIGN EDUC
JOURNAL OF ARTHROPLASTY = J ARTHROPLASTY
JOURNAL OF ARTIFICIAL INTELLIGENCE RESEARCH = J ARTIF INTELL RES
JOURNAL OF ARTS MANAGEMENT LAW AND SOCIETY = J ART MANAG LAW SOC
JOURNAL OF ASIAN AND AFRICAN STUDIES = J ASIAN AFR STUD
JOURNAL OF ASIAN EARTH SCIENCES = J ASIAN EARTH SCI
JOURNAL OF ASIAN HISTORY = J ASIAN HIST
JOURNAL OF ASIAN STUDIES = J ASIAN STUD
JOURNAL OF ASSISTED REPRODUCTION AND GENETICS = J ASSIST REPROD GEN
JOURNAL OF ASTHMA = J ASTHMA
JOURNAL OF ASTROPHYSICS AND ASTRONOMY = J ASTROPHYS ASTRON
JOURNAL OF ATHLETIC TRAINING = J ATHL TRAINING
JOURNAL OF ATMOSPHERIC AND OCEANIC TECHNOLOGY = J ATMOS OCEAN TECH
JOURNAL OF ATMOSPHERIC AND SOLAR-TERRESTRIAL PHYSICS = J ATMOS SOL-TERR PHY
JOURNAL OF ATMOSPHERIC AND TERRESTRIAL PHYSICS = J ATMOS TERR PHYS
JOURNAL OF ATMOSPHERIC CHEMISTRY = J ATMOS CHEM
JOURNAL OF AUDIOVISUAL MEDIA IN MEDICINE = J AUDIOV MEDIA MED
JOURNAL OF AUTISM AND DEVELOPMENTAL DISORDERS = J AUTISM DEV DISORD
JOURNAL OF AUTOIMMUNITY = J AUTOIMMUN
JOURNAL OF AUTOMATED METHODS & MANAGEMENT IN CHEMISTRY = J AUTOM METHOD MANAG
JOURNAL OF AUTOMATED REASONING = J AUTOM REASONING
JOURNAL OF AUTOMATIC CHEMISTRY = J AUTOM CHEM
JOURNAL OF AUTONOMIC PHARMACOLOGY = J AUTON PHARMACOL
JOURNAL OF AVIAN BIOLOGY = J AVIAN BIOL
JOURNAL OF AVIAN MEDICINE AND SURGERY = J AVIAN MED SURG
JOURNAL OF BACK AND MUSCULOSKELETAL REHABILITATION = J BACK MUSCULOSKELET
JOURNAL OF BACTERIOLOGY = J BACTERIOL
JOURNAL OF BALTIC STUDIES = J BALTIC STUD
JOURNAL OF BAND RESEARCH = J BAND RES
JOURNAL OF BANKING & FINANCE = J BANK FINANC
JOURNAL OF BASIC MICROBIOLOGY = J BASIC MICROB
JOURNAL OF BEHAVIOR THERAPY AND EXPERIMENTAL PSYCHIATRY = J BEHAV THER EXP PSY
JOURNAL OF BEHAVIORAL DECISION MAKING = J BEHAV DECIS MAKING
JOURNAL OF BEHAVIORAL HEALTH SERVICES & RESEARCH = J BEHAV HEALTH SER R
JOURNAL OF BEHAVIORAL MEDICINE = J BEHAV MED
JOURNAL OF BIBLICAL LITERATURE = J BIBLICAL LIT
JOURNAL OF BIOACTIVE AND COMPATIBLE POLYMERS = J BIOACT COMPAT POL
JOURNAL OF BIOCHEMICAL AND BIOPHYSICAL METHODS = J BIOCHEM BIOPH METH
JOURNAL OF BIOCHEMICAL AND MOLECULAR TOXICOLOGY = J BIOCHEM MOL TOXIC
JOURNAL OF BIOCHEMICAL TOXICOLOGY = J BIOCHEM TOXICOL
JOURNAL OF BIOCHEMISTRY = J BIOCHEM-TOKYO
JOURNAL OF BIOCHEMISTRY AND MOLECULAR BIOLOGY = J BIOCHEM MOL BIOL
JOURNAL OF BIOELECTRICITY = J BIOELECTRICITY
JOURNAL OF BIOENERGETICS AND BIOMEMBRANES = J BIOENERG BIOMEMBR
JOURNAL OF BIOGEOGRAPHY = J BIOGEOGR
JOURNAL OF BIOLOGICAL CHEMISTRY = J BIOL CHEM
JOURNAL OF BIOLOGICAL EDUCATION = J BIOL EDUC
JOURNAL OF BIOLOGICAL INORGANIC CHEMISTRY = J BIOL INORG CHEM
JOURNAL OF BIOLOGICAL PHYSICS = J BIOL PHYS
JOURNAL OF BIOLOGICAL REGULATORS AND HOMEOSTATIC AGENTS = J BIOL REG HOMEOS AG
JOURNAL OF BIOLOGICAL RESPONSE MODIFIERS = J BIOL RESP MODIF
JOURNAL OF BIOLOGICAL RHYTHMS = J BIOL RHYTHM
JOURNAL OF BIOLOGICAL STANDARDIZATION = J BIOL STAND
JOURNAL OF BIOLOGICAL SYSTEMS = J BIOL SYST
JOURNAL OF BIOLUMINESCENCE AND CHEMILUMINESCENCE = J BIOLUM CHEMILUM
JOURNAL OF BIOMATERIALS APPLICATIONS = J BIOMATER APPL
JOURNAL OF BIOMATERIALS SCIENCE-POLYMER EDITION = J BIOMAT SCI-POLYM E
JOURNAL OF BIOMECHANICAL ENGINEERING-TRANSACTIONS OF THE ASME = J BIOMECH ENG-T ASME
JOURNAL OF BIOMECHANICS = J BIOMECH
JOURNAL OF BIOMEDICAL ENGINEERING = J BIOMED ENG
JOURNAL OF BIOMEDICAL MATERIALS RESEARCH = J BIOMED MATER RES
JOURNAL OF BIOMEDICAL MATERIALS RESEARCH-APPLIED BIOMATERIALS = J BIOMED MATER RES-A
JOURNAL OF BIOMEDICAL OPTICS = J BIOMED OPT
JOURNAL OF BIOMEDICAL SCIENCE = J BIOMED SCI
JOURNAL OF BIOMOLECULAR NMR = J BIOMOL NMR
JOURNAL OF BIOMOLECULAR SCREENING = J BIOMOL SCREEN
JOURNAL OF BIOMOLECULAR STRUCTURE & DYNAMICS = J BIOMOL STRUCT DYN
JOURNAL OF BIOSCIENCE AND BIOENGINEERING = J BIOSCI BIOENG
JOURNAL OF BIOSCIENCES = J BIOSCIENCE
JOURNAL OF BIOSOCIAL SCIENCE = J BIOSOC SCI
JOURNAL OF BIOTECHNOLOGY = J BIOTECHNOL
JOURNAL OF BLACK STUDIES = J BLACK STUD
JOURNAL OF BLACKS IN HIGHER EDUCATION = J BLACKS HIGH EDUC
JOURNAL OF BONE AND JOINT SURGERY-AMERICAN VOLUME = J BONE JOINT SURG AM
JOURNAL OF BONE AND JOINT SURGERY-BRITISH VOLUME = J BONE JOINT SURG BR
JOURNAL OF BONE AND MINERAL METABOLISM = J BONE MINER METAB
JOURNAL OF BONE AND MINERAL RESEARCH = J BONE MINER RES
JOURNAL OF BRAIN RESEARCH-JOURNAL FUR HIRNFORSCHUNG = J BRAIN RES
JOURNAL OF BRAIN SCIENCE = J BRAIN SCI
JOURNAL OF BRITISH STUDIES = J BRIT STUD
JOURNAL OF BROADCASTING & ELECTRONIC MEDIA = J BROADCAST ELECTRON
JOURNAL OF BRYOLOGY = J BRYOL
JOURNAL OF BURN CARE & REHABILITATION = J BURN CARE REHABIL
JOURNAL OF BUSINESS = J BUS
JOURNAL OF BUSINESS & ECONOMIC STATISTICS = J BUS ECON STAT
JOURNAL OF BUSINESS AND PSYCHOLOGY = J BUS PSYCHOL
JOURNAL OF BUSINESS AND TECHNICAL COMMUNICATION = J BUS TECH COMMUN
JOURNAL OF BUSINESS ETHICS = J BUS ETHICS
JOURNAL OF BUSINESS RESEARCH = J BUS RES
JOURNAL OF BUSINESS VENTURING = J BUS VENTURING
JOURNAL OF CAMEL PRACTICE AND RESEARCH = J CAMEL PRACT RES
JOURNAL OF CANADIAN ART HISTORY-ANNALES D HISTOIRE DE L ART CANADIEN = J CAN ART HIST
JOURNAL OF CANADIAN PETROLEUM TECHNOLOGY = J CAN PETROL TECHNOL
JOURNAL OF CANADIAN STUDIES-REVUE D ETUDES CANADIENNES = J CAN STUD
JOURNAL OF CANCER EDUCATION = J CANCER EDUC
JOURNAL OF CANCER RESEARCH AND CLINICAL ONCOLOGY = J CANCER RES CLIN
JOURNAL OF CAPILLARY ELECTROPHORESIS = J CAPILLARY ELECTROP
JOURNAL OF CARBOHYDRATE CHEMISTRY = J CARBOHYD CHEM
JOURNAL OF CARBOHYDRATES-NUCLEOSIDES-NUCLEOTIDES = J CARB-NUCLEOS-NUCL
JOURNAL OF CARDIAC FAILURE = J CARD FAIL
JOURNAL OF CARDIAC SURGERY = J CARDIAC SURG
JOURNAL OF CARDIOTHORACIC AND VASCULAR ANESTHESIA = J CARDIOTHOR VASC AN
JOURNAL OF CARDIOVASCULAR DIAGNOSIS AND PROCEDURES = J CARDIOVASC DIAGN P
JOURNAL OF CARDIOVASCULAR ELECTROPHYSIOLOGY = J CARDIOVASC ELECTR
JOURNAL OF CARDIOVASCULAR MAGNETIC RESONANCE = J CARDIOV MAGN RESON
JOURNAL OF CARDIOVASCULAR MEDICINE = J CARDIOVASC MED
JOURNAL OF CARDIOVASCULAR PHARMACOLOGY = J CARDIOVASC PHARM
JOURNAL OF CARDIOVASCULAR RISK = J CARDIOVASC RISK
JOURNAL OF CARDIOVASCULAR SURGERY = J CARDIOVASC SURG
JOURNAL OF CARDIOVASCULAR TECHNOLOGY = J CARDIOVASC TECHNOL
JOURNAL OF CARDIOVASCULAR ULTRASONOGRAPHY = J CARDIOVASC ULTRAS
JOURNAL OF CAREER ASSESSMENT = J CAREER ASSESSMENT
JOURNAL OF CAREER DEVELOPMENT = J CAREER DEV
JOURNAL OF CARIBBEAN HISTORY = J CARIBBEAN HIST
JOURNAL OF CATALYSIS = J CATAL
JOURNAL OF CATARACT AND REFRACTIVE SURGERY = J CATARACT REFR SURG
JOURNAL OF CELL BIOLOGY = J CELL BIOL
JOURNAL OF CELL SCIENCE = J CELL SCI
JOURNAL OF CELLULAR BIOCHEMISTRY = J CELL BIOCHEM
JOURNAL OF CELLULAR PHYSIOLOGY = J CELL PHYSIOL
JOURNAL OF CELLULAR PLASTICS = J CELL PLAST
JOURNAL OF CEREAL SCIENCE = J CEREAL SCI
JOURNAL OF CEREBRAL BLOOD FLOW AND METABOLISM = J CEREBR BLOOD F MET
JOURNAL OF CHEMICAL AND ENGINEERING DATA = J CHEM ENG DATA
JOURNAL OF CHEMICAL CRYSTALLOGRAPHY = J CHEM CRYSTALLOGR
JOURNAL OF CHEMICAL ECOLOGY = J CHEM ECOL
JOURNAL OF CHEMICAL EDUCATION = J CHEM EDUC
JOURNAL OF CHEMICAL ENGINEERING OF JAPAN = J CHEM ENG JPN
JOURNAL OF CHEMICAL INFORMATION AND COMPUTER SCIENCES = J CHEM INF COMP SCI
JOURNAL OF CHEMICAL NEUROANATOMY = J CHEM NEUROANAT
JOURNAL OF CHEMICAL PHYSICS = J CHEM PHYS
JOURNAL OF CHEMICAL RESEARCH-S = J CHEM RES-S
JOURNAL OF CHEMICAL TECHNOLOGY AND BIOTECHNOLOGY = J CHEM TECHNOL BIOT
JOURNAL OF CHEMICAL TECHNOLOGY AND BIOTECHNOLOGY A-CHEMICAL TECHNOLOGY = J CHEM TECH BIOT A
JOURNAL OF CHEMICAL TECHNOLOGY AND BIOTECHNOLOGY A-CHEMICAL TECHNOLOGY = J CHEM TECHNOL BIOT
JOURNAL OF CHEMICAL TECHNOLOGY AND BIOTECHNOLOGY B-BIOTECHNOLOGY = J CHEM TECH BIOT B
JOURNAL OF CHEMICAL TECHNOLOGY AND BIOTECHNOLOGY B-BIOTECHNOLOGY = J CHEM TECHNOL BIOT
JOURNAL OF CHEMICAL THERMODYNAMICS = J CHEM THERMODYN
JOURNAL OF CHEMOMETRICS = J CHEMOMETR
JOURNAL OF CHEMOTHERAPY = J CHEMOTHERAPY
JOURNAL OF CHILD & ADOLESCENT SUBSTANCE ABUSE = J CHILD ADOLES SUBST
JOURNAL OF CHILD AND ADOLESCENT PSYCHOPHARMACOLOGY = J CHILD ADOL PSYCHOP
JOURNAL OF CHILD LANGUAGE = J CHILD LANG
JOURNAL OF CHILD NEUROLOGY = J CHILD NEUROL
JOURNAL OF CHILD PSYCHOLOGY AND PSYCHIATRY AND ALLIED DISCIPLINES = J CHILD PSYCHOL PSYC
JOURNAL OF CHINESE LINGUISTICS = J CHINESE LINGUIST
JOURNAL OF CHINESE PHILOSOPHY = J CHINESE PHILOS
JOURNAL OF CHROMATOGRAPHIC SCIENCE = J CHROMATOGR SCI
JOURNAL OF CHROMATOGRAPHY = J CHROMATOGR
JOURNAL OF CHROMATOGRAPHY A = J CHROMATOGR A
JOURNAL OF CHROMATOGRAPHY B = J CHROMATOGR B
JOURNAL OF CHROMATOGRAPHY B-BIOMEDICAL APPLICATIONS = J CHROMATOGR B
JOURNAL OF CHROMATOGRAPHY-BIOMEDICAL APPLICATIONS = J CHROMATOGR-BIOMED
JOURNAL OF CHRONIC DISEASES = J CHRON DIS
JOURNAL OF CHURCH AND STATE = J CHURCH STATE
JOURNAL OF CIRCUITS SYSTEMS AND COMPUTERS = J CIRCUIT SYST COMP
JOURNAL OF CLASSIFICATION = J CLASSIF
JOURNAL OF CLEAN TECHNOLOGY AND ENVIRONMENTAL SCIENCES = J CLEAN TECHNOL ENV
JOURNAL OF CLEAN TECHNOLOGY ENVIRONMENTAL TOXICOLOGY AND OCCUPATIONAL MEDICINE = J CLEAN TECHNOL E T
JOURNAL OF CLIMATE = J CLIMATE
JOURNAL OF CLIMATE AND APPLIED METEOROLOGY = J CLIM APPL METEOROL
JOURNAL OF CLIMATOLOGY = J CLIMATOL
JOURNAL OF CLINICAL & LABORATORY IMMUNOLOGY = J CLIN LAB IMMUNOL
JOURNAL OF CLINICAL AND EXPERIMENTAL GERONTOLOGY = J CLIN EXP GERONTOL
JOURNAL OF CLINICAL AND EXPERIMENTAL NEUROPSYCHOLOGY = J CLIN EXP NEUROPSYC
JOURNAL OF CLINICAL AND HOSPITAL PHARMACY = J CLIN HOSP PHARM
JOURNAL OF CLINICAL ANESTHESIA = J CLIN ANESTH
JOURNAL OF CLINICAL APHERESIS = J CLIN APHERESIS
JOURNAL OF CLINICAL BIOCHEMISTRY AND NUTRITION = J CLIN BIOCHEM NUTR
JOURNAL OF CLINICAL CHEMISTRY AND CLINICAL BIOCHEMISTRY = J CLIN CHEM CLIN BIO
JOURNAL OF CLINICAL CHILD PSYCHOLOGY = J CLIN CHILD PSYCHOL
JOURNAL OF CLINICAL DENSITOMETRY = J CLIN DENSITOM
JOURNAL OF CLINICAL DENTISTRY = J CLIN DENT
JOURNAL OF CLINICAL ENDOCRINOLOGY AND METABOLISM = J CLIN ENDOCR METAB
JOURNAL OF CLINICAL EPIDEMIOLOGY = J CLIN EPIDEMIOL
JOURNAL OF CLINICAL ETHICS = J CLIN ETHIC
JOURNAL OF CLINICAL GASTROENTEROLOGY = J CLIN GASTROENTEROL
JOURNAL OF CLINICAL HEMATOLOGY AND ONCOLOGY = J CLIN HEMATOL ONCOL
JOURNAL OF CLINICAL HYPERTENSION = J CLIN HYPERTENS
JOURNAL OF CLINICAL IMMUNOASSAY = J CLIN IMMUNOASSAY
JOURNAL OF CLINICAL IMMUNOLOGY = J CLIN IMMUNOL
JOURNAL OF CLINICAL INVESTIGATION = J CLIN INVEST
JOURNAL OF CLINICAL LABORATORY ANALYSIS = J CLIN LAB ANAL
JOURNAL OF CLINICAL LABORATORY AUTOMATION = J CLIN LAB AUTOMAT
JOURNAL OF CLINICAL LASER MEDICINE & SURGERY = J CLIN LASER MED SUR
JOURNAL OF CLINICAL LIGAND ASSAY = J CLIN LIGAND ASSAY
JOURNAL OF CLINICAL MICROBIOLOGY = J CLIN MICROBIOL
JOURNAL OF CLINICAL MONITORING = J CLIN MONITOR
JOURNAL OF CLINICAL MONITORING AND COMPUTING = J CLIN MONITOR COMP
JOURNAL OF CLINICAL NEURO-OPHTHALMOLOGY = J CLIN NEURO-OPHTHAL
JOURNAL OF CLINICAL NEUROPHYSIOLOGY = J CLIN NEUROPHYSIOL
JOURNAL OF CLINICAL NEUROPSYCHOLOGY = J CLIN NEUROPSYCHOL
JOURNAL OF CLINICAL NEUROSCIENCE = J CLIN NEUROSCI
JOURNAL OF CLINICAL NURSING = J CLIN NURS
JOURNAL OF CLINICAL ONCOLOGY = J CLIN ONCOL
JOURNAL OF CLINICAL PATHOLOGY = J CLIN PATHOL
JOURNAL OF CLINICAL PATHOLOGY-CLINICAL MOLECULAR PATHOLOGY EDITION = J CLIN PATHOL-CL MOL
JOURNAL OF CLINICAL PATHOLOGY-MOLECULAR PATHOLOGY = J CLIN PATHOL-MOL PA
JOURNAL OF CLINICAL PERIODONTOLOGY = J CLIN PERIODONTOL
JOURNAL OF CLINICAL PHARMACOLOGY = J CLIN PHARMACOL
JOURNAL OF CLINICAL PHARMACY AND THERAPEUTICS = J CLIN PHARM THER
JOURNAL OF CLINICAL PSYCHIATRY = J CLIN PSYCHIAT
JOURNAL OF CLINICAL PSYCHOLOGY = J CLIN PSYCHOL
JOURNAL OF CLINICAL PSYCHOLOGY IN MEDICAL SETTINGS = J CLIN PSYCHOL MED S
JOURNAL OF CLINICAL PSYCHOPHARMACOLOGY = J CLIN PSYCHOPHARM
JOURNAL OF CLINICAL SURGERY-APPLIED PHYSIOLOGY & METABOLISM = J CLIN SURG-APPL PHY
JOURNAL OF CLINICAL ULTRASOUND = J CLIN ULTRASOUND
JOURNAL OF CLINICAL VIROLOGY = J CLIN VIROL
JOURNAL OF CLUSTER SCIENCE = J CLUST SCI
JOURNAL OF COASTAL RESEARCH = J COASTAL RES
JOURNAL OF COATED FABRICS = J COATED FABRICS
JOURNAL OF COATINGS TECHNOLOGY = J COATING TECHNOL
JOURNAL OF COGNITIVE NEUROSCIENCE = J COGNITIVE NEUROSCI
JOURNAL OF COLD REGIONS ENGINEERING = J COLD REG ENG
JOURNAL OF COLLECTIVE NEGOTIATIONS IN THE PUBLIC SECTOR = J COLLECT NEG PUB SE
JOURNAL OF COLLEGE STUDENT DEVELOPMENT = J COLL STUDENT DEV
JOURNAL OF COLLOID AND INTERFACE SCIENCE = J COLLOID INTERF SCI
JOURNAL OF COMBINATORIAL CHEMISTRY = J COMB CHEM
JOURNAL OF COMBINATORIAL DESIGNS = J COMB DES
JOURNAL OF COMBINATORIAL OPTIMIZATION = J COMB OPTIM
JOURNAL OF COMBINATORIAL THEORY SERIES A = J COMB THEORY A
JOURNAL OF COMBINATORIAL THEORY SERIES B = J COMB THEORY B
JOURNAL OF COMBUSTION TOXICOLOGY = J COMBUST TOXICOL
JOURNAL OF COMMON MARKET STUDIES = J COMMON MARK STUD
JOURNAL OF COMMONWEALTH & COMPARATIVE POLITICS = J COMMONW COMP POLIT
JOURNAL OF COMMONWEALTH LITERATURE = J COMMONW LIT
JOURNAL OF COMMUNICATION = J COMMUN
JOURNAL OF COMMUNICATION DISORDERS = J COMMUN DISORD
JOURNAL OF COMMUNICATIONS TECHNOLOGY AND ELECTRONICS = J COMMUN TECHNOL EL+
JOURNAL OF COMMUNITY & APPLIED SOCIAL PSYCHOLOGY = J COMMUNITY APPL SOC
JOURNAL OF COMMUNITY HEALTH = J COMMUN HEALTH
JOURNAL OF COMMUNITY PSYCHOLOGY = J COMMUNITY PSYCHOL
JOURNAL OF COMPARATIVE AND PHYSIOLOGICAL PSYCHOLOGY = J COMP PHYSIOL PSYCH
JOURNAL OF COMPARATIVE ECONOMICS = J COMP ECON
JOURNAL OF COMPARATIVE FAMILY STUDIES = J COMP FAM STUD
JOURNAL OF COMPARATIVE NEUROLOGY = J COMP NEUROL
JOURNAL OF COMPARATIVE PATHOLOGY = J COMP PATHOL
JOURNAL OF COMPARATIVE PHYSIOLOGY = J COMP PHYSIOL
JOURNAL OF COMPARATIVE PHYSIOLOGY A-SENSORY NEURAL AND BEHAVIORAL PHYSIOLOGY = J COMP PHYSIOL A
JOURNAL OF COMPARATIVE PHYSIOLOGY B-BIOCHEMICAL SYSTEMIC AND ENVIRONMENTAL PHYSIOLOGY = J COMP PHYSIOL B
JOURNAL OF COMPARATIVE PSYCHOLOGY = J COMP PSYCHOL
JOURNAL OF COMPLEXITY = J COMPLEXITY
JOURNAL OF COMPOSITE MATERIALS = J COMPOS MATER
JOURNAL OF COMPOSITES TECHNOLOGY & RESEARCH = J COMPOS TECH RES
JOURNAL OF COMPUTATIONAL ACOUSTICS = J COMPUT ACOUST
JOURNAL OF COMPUTATIONAL AND APPLIED MATHEMATICS = J COMPUT APPL MATH
JOURNAL OF COMPUTATIONAL AND GRAPHICAL STATISTICS = J COMPUT GRAPH STAT
JOURNAL OF COMPUTATIONAL BIOLOGY = J COMPUT BIOL
JOURNAL OF COMPUTATIONAL CHEMISTRY = J COMPUT CHEM
JOURNAL OF COMPUTATIONAL MATHEMATICS = J COMPUT MATH
JOURNAL OF COMPUTATIONAL NEUROSCIENCE = J COMPUT NEUROSCI
JOURNAL OF COMPUTATIONAL PHYSICS = J COMPUT PHYS
JOURNAL OF COMPUTER AND SYSTEM SCIENCES = J COMPUT SYST SCI
JOURNAL OF COMPUTER AND SYSTEMS SCIENCES INTERNATIONAL = J COMPUT SYS SC INT+
JOURNAL OF COMPUTER ASSISTED LEARNING = J COMPUT ASSIST LEAR
JOURNAL OF COMPUTER ASSISTED TOMOGRAPHY = J COMPUT ASSIST TOMO
JOURNAL OF COMPUTER INFORMATION SYSTEMS = J COMPUT INFORM SYST
JOURNAL OF COMPUTER-AIDED MOLECULAR DESIGN = J COMPUT AID MOL DES
JOURNAL OF COMPUTER-BASED INSTRUCTION = J COMPUT-BASE INSTR
JOURNAL OF COMPUTING IN CIVIL ENGINEERING = J COMPUT CIVIL ENG
JOURNAL OF CONCHOLOGY = J CONCHOL
JOURNAL OF CONFLICT RESOLUTION = J CONFLICT RESOLUT
JOURNAL OF CONSTRUCTION ENGINEERING AND MANAGEMENT-ASCE = J CONSTR ENG M ASCE
JOURNAL OF CONSTRUCTIONAL STEEL RESEARCH = J CONSTR STEEL RES
JOURNAL OF CONSTRUCTIVIST PSYCHOLOGY = J CONSTR PSYCHOL
JOURNAL OF CONSULTING AND CLINICAL PSYCHOLOGY = J CONSULT CLIN PSYCH
JOURNAL OF CONSUMER AFFAIRS = J CONSUM AFF
JOURNAL OF CONSUMER PRODUCT FLAMMABILITY = J CONSUM PROD FLAMMA
JOURNAL OF CONSUMER PSYCHOLOGY = J CONSUM PSYCHOL
JOURNAL OF CONSUMER RESEARCH = J CONSUM RES
JOURNAL OF CONTAMINANT HYDROLOGY = J CONTAM HYDROL
JOURNAL OF CONTEMPORARY ASIA = J CONTEMP ASIA
JOURNAL OF CONTEMPORARY ETHNOGRAPHY = J CONTEMP ETHNOGR
JOURNAL OF CONTEMPORARY HISTORY = J CONTEMP HIST
JOURNAL OF CONTROLLED RELEASE = J CONTROL RELEASE
JOURNAL OF COORDINATION CHEMISTRY = J COORD CHEM
JOURNAL OF CORPORATE TAXATION = J CORP TAX
JOURNAL OF COSMETIC SCIENCE = J COSMET SCI
JOURNAL OF COUNSELING AND DEVELOPMENT = J COUNS DEV
JOURNAL OF COUNSELING PSYCHOLOGY = J COUNS PSYCHOL
JOURNAL OF COUNTRY MUSIC = J COUNTRY MUSIC
JOURNAL OF CRANIO-MAXILLO-FACIAL SURGERY = J CRANIO MAXILL SURG
JOURNAL OF CRANIO-MAXILLOFACIAL SURGERY = J CRANIO MAXILL SURG
JOURNAL OF CRANIOFACIAL GENETICS AND DEVELOPMENTAL BIOLOGY = J CRAN GENET DEV BIO
JOURNAL OF CRANIOFACIAL SURGERY = J CRANIOFAC SURG
JOURNAL OF CREATIVE BEHAVIOR = J CREATIVE BEHAV
JOURNAL OF CRIMINAL JUSTICE = J CRIM JUST
JOURNAL OF CRIMINAL LAW & CRIMINOLOGY = J CRIM LAW CRIM
JOURNAL OF CRITICAL CARE = J CRIT CARE
JOURNAL OF CROSS-CULTURAL PSYCHOLOGY = J CROSS CULT PSYCHOL
JOURNAL OF CRUSTACEAN BIOLOGY = J CRUSTACEAN BIOL
JOURNAL OF CRYPTOLOGY = J CRYPTOL
JOURNAL OF CRYSTAL AND MOLECULAR STRUCTURE = J CRYST MOL STRUCT
JOURNAL OF CRYSTAL GROWTH = J CRYST GROWTH
JOURNAL OF CRYSTALLOGRAPHIC AND SPECTROSCOPIC RESEARCH = J CRYST SPECTROSC
JOURNAL OF CURRICULUM STUDIES = J CURRICULUM STUD
JOURNAL OF CUTANEOUS PATHOLOGY = J CUTAN PATHOL
JOURNAL OF CYCLIC NUCLEOTIDE AND PROTEIN PHOSPHORYLATION RESEARCH = J CYCLIC NUCL PROT
JOURNAL OF CYCLIC NUCLEOTIDE RESEARCH = J CYCLIC NUCL PROT
JOURNAL OF CYTOLOGY AND GENETICS = J CYTOL GENET
JOURNAL OF DAIRY RESEARCH = J DAIRY RES
JOURNAL OF DAIRY SCIENCE = J DAIRY SCI
JOURNAL OF DEMOCRACY = J DEMOCR
JOURNAL OF DENTAL RESEARCH = J DENT RES
JOURNAL OF DENTISTRY = J DENT
JOURNAL OF DENTISTRY FOR CHILDREN = J DENT CHILD
JOURNAL OF DERMATOLOGIC SURGERY AND ONCOLOGY = J DERMATOL SURG ONC
JOURNAL OF DERMATOLOGICAL SCIENCE = J DERMATOL SCI
JOURNAL OF DERMATOLOGICAL TREATMENT = J DERMATOL TREAT
JOURNAL OF DEVELOPING AREAS = J DEV AREAS
JOURNAL OF DEVELOPMENT ECONOMICS = J DEV ECON
JOURNAL OF DEVELOPMENT STUDIES = J DEV STUD
JOURNAL OF DEVELOPMENTAL AND BEHAVIORAL PEDIATRICS = J DEV BEHAV PEDIATR
JOURNAL OF DEVELOPMENTAL AND PHYSICAL DISABILITIES = J DEV PHYS DISABIL
JOURNAL OF DEVELOPMENTAL PHYSIOLOGY = J DEV PHYSIOL
JOURNAL OF DHARMA = J DHARMA
JOURNAL OF DIABETES AND ITS COMPLICATIONS = J DIABETES COMPLICAT
JOURNAL OF DIAGNOSTIC MEDICAL SONOGRAPHY = J DIAGN MED SONOG
JOURNAL OF DIARRHOEAL DISEASES RESEARCH = J DIARRHOEAL DIS RES
JOURNAL OF DIFFERENCE EQUATIONS AND APPLICATIONS = J DIFFER EQU APPL
JOURNAL OF DIFFERENTIAL EQUATIONS = J DIFFER EQUATIONS
JOURNAL OF DIFFERENTIAL GEOMETRY = J DIFFER GEOM
JOURNAL OF DIGITAL IMAGING = J DIGIT IMAGING
JOURNAL OF DIGITAL SYSTEMS = J DIGITAL SYST
JOURNAL OF DISPERSION SCIENCE AND TECHNOLOGY = J DISPER SCI TECHNOL
JOURNAL OF DIVORCE & REMARRIAGE = J DIVORCE REMARRIAGE
JOURNAL OF DOCUMENTATION = J DOC
JOURNAL OF DRUG DEVELOPMENT = J DRUG DEV
JOURNAL OF DRUG DEVELOPMENT AND CLINICAL PRACTICE = J DRUG DEV CLIN PR
JOURNAL OF DRUG EDUCATION = J DRUG EDUC
JOURNAL OF DRUG ISSUES = J DRUG ISSUES
JOURNAL OF DRUG TARGETING = J DRUG TARGET
JOURNAL OF DYNAMIC SYSTEMS MEASUREMENT AND CONTROL-TRANSACTIONS OF THE ASME = J DYN SYST-T ASME
JOURNAL OF EARLY ADOLESCENCE = J EARLY ADOLESCENCE
JOURNAL OF EARLY CHRISTIAN STUDIES = J EARLY CHRISTIAN ST
JOURNAL OF EARLY INTERVENTION = J EARLY INTERVENTION
JOURNAL OF EARTH SCIENCES ROYAL DUBLIN SOCIETY = J EARTH SCI-DUBLIN
JOURNAL OF EARTHQUAKE ENGINEERING = J EARTHQUAKE ENG
JOURNAL OF EAST ASIAN LINGUISTICS = J EAST ASIAN LINGUIS
JOURNAL OF ECCLESIASTICAL HISTORY = J ECCLESIAST HIST
JOURNAL OF ECOLOGY = J ECOL
JOURNAL OF ECONOMETRICS = J ECONOMETRICS
JOURNAL OF ECONOMIC BEHAVIOR & ORGANIZATION = J ECON BEHAV ORGAN
JOURNAL OF ECONOMIC DYNAMICS & CONTROL = J ECON DYN CONTROL
JOURNAL OF ECONOMIC EDUCATION = J ECON EDUC
JOURNAL OF ECONOMIC ENTOMOLOGY = J ECON ENTOMOL
JOURNAL OF ECONOMIC GROWTH = J ECON GROWTH
JOURNAL OF ECONOMIC HISTORY = J ECON HIST
JOURNAL OF ECONOMIC ISSUES = J ECON ISSUES
JOURNAL OF ECONOMIC LITERATURE = J ECON LIT
JOURNAL OF ECONOMIC PERSPECTIVES = J ECON PERSPECT
JOURNAL OF ECONOMIC PSYCHOLOGY = J ECON PSYCHOL
JOURNAL OF ECONOMIC THEORY = J ECON THEORY
JOURNAL OF ECONOMICS & MANAGEMENT STRATEGY = J ECON MANAGE STRAT
JOURNAL OF ECONOMICS-ZEITSCHRIFT FUR NATIONALOKONOMIE = J ECON
JOURNAL OF ECT = J ECT
JOURNAL OF ECUMENICAL STUDIES = J ECUMENICAL STUD
JOURNAL OF EDUCATION FOR LIBRARY AND INFORMATION SCIENCE = J EDUC LIBR INF SCI
JOURNAL OF EDUCATION FOR TEACHING = J EDUC TEACHING
JOURNAL OF EDUCATION POLICY = J EDUC POLICY
JOURNAL OF EDUCATIONAL AND BEHAVIORAL STATISTICS = J EDUC BEHAV STAT
JOURNAL OF EDUCATIONAL AND PSYCHOLOGICAL CONSULTATION = J EDUC PSYCHOL CONS
JOURNAL OF EDUCATIONAL COMPUTING RESEARCH = J EDUC COMPUT RES
JOURNAL OF EDUCATIONAL MEASUREMENT = J EDUC MEAS
JOURNAL OF EDUCATIONAL PSYCHOLOGY = J EDUC PSYCHOL
JOURNAL OF EDUCATIONAL RESEARCH = J EDUC RES
JOURNAL OF EDUCATIONAL STATISTICS = J EDUC STAT
JOURNAL OF EDUCATIONAL TELEVISION = J EDUC TV
JOURNAL OF EGYPTIAN ARCHAEOLOGY = J EGYPT ARCHAEOL
JOURNAL OF ELASTICITY = J ELASTICITY
JOURNAL OF ELASTOMERS AND PLASTICS = J ELASTOM PLAST
JOURNAL OF ELDER ABUSE & NEGLECT = J ELDER ABUSE NEGL
JOURNAL OF ELECTROANALYTICAL CHEMISTRY = J ELECTROANAL CHEM
JOURNAL OF ELECTROCARDIOLOGY = J ELECTROCARDIOL
JOURNAL OF ELECTROCERAMICS = J ELECTROCERAM
JOURNAL OF ELECTROMAGNETIC WAVES AND APPLICATIONS = J ELECTROMAGNET WAVE
JOURNAL OF ELECTROMYOGRAPHY AND KINESIOLOGY = J ELECTROMYOGR KINES
JOURNAL OF ELECTRON MICROSCOPY = J ELECTRON MICROSC
JOURNAL OF ELECTRON MICROSCOPY TECHNIQUE = J ELECTRON MICR TECH
JOURNAL OF ELECTRON SPECTROSCOPY AND RELATED PHENOMENA = J ELECTRON SPECTROSC
JOURNAL OF ELECTRONIC IMAGING = J ELECTRON IMAGING
JOURNAL OF ELECTRONIC MATERIALS = J ELECTRON MATER
JOURNAL OF ELECTRONIC PACKAGING = J ELECTRON PACKAGING
JOURNAL OF ELECTRONIC TESTING-THEORY AND APPLICATIONS = J ELECTRON TEST
JOURNAL OF ELECTRONICS MANUFACTURING = J ELECTRON MANUF
JOURNAL OF ELECTROPHYSIOLOGICAL TECHNIQUES = J ELECTROPHYSIOL TEC
JOURNAL OF ELECTROSTATICS = J ELECTROSTAT
JOURNAL OF EMBRYOLOGY AND EXPERIMENTAL MORPHOLOGY = J EMBRYOL EXP MORPH
JOURNAL OF EMERGENCY MEDICINE = J EMERG MED
JOURNAL OF EMOTIONAL AND BEHAVIORAL DISORDERS = J EMOT BEHAV DISORD
JOURNAL OF EMPLOYMENT COUNSELING = J EMPLOYMENT COUNS
JOURNAL OF ENDOCRINOLOGICAL INVESTIGATION = J ENDOCRINOL INVEST
JOURNAL OF ENDOCRINOLOGY = J ENDOCRINOL
JOURNAL OF ENDODONTICS = J ENDODONT
JOURNAL OF ENDOTOXIN RESEARCH = J ENDOTOXIN RES
JOURNAL OF ENDOUROLOGY = J ENDOUROL
JOURNAL OF ENDOVASCULAR SURGERY = J ENDOVASC SURG
JOURNAL OF ENDOVASCULAR THERAPY = J ENDOVASC THER
JOURNAL OF ENERGY = J ENERGY
JOURNAL OF ENERGY AND DEVELOPMENT = J ENERGY DEV
JOURNAL OF ENERGY ENGINEERING-ASCE = J ENERG ENG-ASCE
JOURNAL OF ENERGY RESOURCES TECHNOLOGY-TRANSACTIONS OF THE ASME = J ENERG RESOUR-ASME
JOURNAL OF ENGINEERING AND APPLIED SCIENCES = J ENG APPL SCI
JOURNAL OF ENGINEERING AND TECHNOLOGY MANAGEMENT = J ENG TECHNOL MANAGE
JOURNAL OF ENGINEERING DESIGN = J ENG DESIGN
JOURNAL OF ENGINEERING FOR GAS TURBINES AND POWER-TRANSACTIONS OF THE ASME = J ENG GAS TURB POWER
JOURNAL OF ENGINEERING FOR INDUSTRY-TRANSACTIONS OF THE ASME = J ENG IND-T ASME
JOURNAL OF ENGINEERING FOR POWER-TRANSACTIONS OF THE ASME = J ENG POWER-T ASME
JOURNAL OF ENGINEERING MATERIALS AND TECHNOLOGY-TRANSACTIONS OF THE ASME = J ENG MATER-T ASME
JOURNAL OF ENGINEERING MATHEMATICS = J ENG MATH
JOURNAL OF ENGINEERING MECHANICS-ASCE = J ENG MECH-ASCE
JOURNAL OF ENGINEERING SCIENCES = J ENG SCI
JOURNAL OF ENGINEERING TECHNOLOGY = J ENG TECHNOL
JOURNAL OF ENGLISH AND GERMANIC PHILOLOGY = J ENGL GER PHILOL
JOURNAL OF ENHANCED HEAT TRANSFER = J ENHANC HEAT TRANSF
JOURNAL OF ENTOMOLOGICAL SCIENCE = J ENTOMOL SCI
JOURNAL OF ENVIRONMENTAL BIOLOGY = J ENVIRON BIOL
JOURNAL OF ENVIRONMENTAL ECONOMICS AND MANAGEMENT = J ENVIRON ECON MANAG
JOURNAL OF ENVIRONMENTAL EDUCATION = J ENVIRON EDUC
JOURNAL OF ENVIRONMENTAL ENGINEERING-ASCE = J ENVIRON ENG-ASCE
JOURNAL OF ENVIRONMENTAL HEALTH = J ENVIRON HEALTH
JOURNAL OF ENVIRONMENTAL LAW = J ENVIRON LAW
JOURNAL OF ENVIRONMENTAL MANAGEMENT = J ENVIRON MANAGE
JOURNAL OF ENVIRONMENTAL MONITORING = J ENVIRON MONITOR
JOURNAL OF ENVIRONMENTAL PATHOLOGY AND TOXICOLOGY = J ENVIRON PATHOL TOX
JOURNAL OF ENVIRONMENTAL PATHOLOGY TOXICOLOGY AND ONCOLOGY = J ENVIRON PATHOL TOX
JOURNAL OF ENVIRONMENTAL PERMITTING = J ENVIRON PERMITTING
JOURNAL OF ENVIRONMENTAL POLYMER DEGRADATION = J ENVIRON POLYM DEGR
JOURNAL OF ENVIRONMENTAL PSYCHOLOGY = J ENVIRON PSYCHOL
JOURNAL OF ENVIRONMENTAL QUALITY = J ENVIRON QUAL
JOURNAL OF ENVIRONMENTAL RADIOACTIVITY = J ENVIRON RADIOACTIV
JOURNAL OF ENVIRONMENTAL SCIENCE AND HEALTH PART A-ENVIRONMENTAL SCIENCE AND ENGINEERING & TOXIC AND HAZARDOUS SUBSTANCE CONTROL = J ENVIRON SCI HEAL A
JOURNAL OF ENVIRONMENTAL SCIENCE AND HEALTH PART A-TOXIC/HAZARDOUS SUBSTANCES & ENVIRONMENTAL ENGINEERING = J ENVIRON SCI HEAL A
JOURNAL OF ENVIRONMENTAL SCIENCE AND HEALTH PART B-PESTICIDES FOOD CONTAMINANTS AND AGRICULTURAL WASTES = J ENVIRON SCI HEAL B
JOURNAL OF ENVIRONMENTAL SCIENCE AND HEALTH PART C-ENVIRONMENTAL CARCINOGENESIS REVIEWS = J ENVIRON SCI HEAL C
JOURNAL OF ENVIRONMENTAL SCIENCES = J ENVIRON SCI
JOURNAL OF ENVIRONMENTAL SYSTEMS = J ENVIRON SYST
JOURNAL OF ENZYME INHIBITION = J ENZYM INHIB
JOURNAL OF EPIDEMIOLOGY AND COMMUNITY HEALTH = J EPIDEMIOL COMMUN H
JOURNAL OF EPILEPSY = J EPILEPSY
JOURNAL OF EQUINE VETERINARY SCIENCE = J EQUINE VET SCI
JOURNAL OF ETHNOPHARMACOLOGY = J ETHNOPHARMACOL
JOURNAL OF ETHOLOGY = J ETHOL
JOURNAL OF EUKARYOTIC MICROBIOLOGY = J EUKARYOT MICROBIOL
JOURNAL OF EUROPEAN PUBLIC POLICY = J EUR PUBLIC POLICY
JOURNAL OF EUROPEAN SOCIAL POLICY = J EUR SOC POLICY
JOURNAL OF EUROPEAN STUDIES = J EUR STUD
JOURNAL OF EVALUATION IN CLINICAL PRACTICE = J EVAL CLIN PRACT
JOURNAL OF EVOLUTIONARY BIOCHEMISTRY AND PHYSIOLOGY = J EVOL BIOCHEM PHYS+
JOURNAL OF EVOLUTIONARY BIOLOGY = J EVOLUTION BIOL
JOURNAL OF EVOLUTIONARY ECONOMICS = J EVOL ECON
JOURNAL OF EXPERIMENTAL & CLINICAL CANCER RESEARCH = J EXP CLIN CANC RES
JOURNAL OF EXPERIMENTAL & THEORETICAL ARTIFICIAL INTELLIGENCE = J EXP THEOR ARTIF IN
JOURNAL OF EXPERIMENTAL AND THEORETICAL PHYSICS = J EXP THEOR PHYS+
JOURNAL OF EXPERIMENTAL ANIMAL SCIENCE = J EXP ANIM SCI
JOURNAL OF EXPERIMENTAL BIOLOGY = J EXP BIOL
JOURNAL OF EXPERIMENTAL BOTANY = J EXP BOT
JOURNAL OF EXPERIMENTAL CHILD PSYCHOLOGY = J EXP CHILD PSYCHOL
JOURNAL OF EXPERIMENTAL EDUCATION = J EXP EDUC
JOURNAL OF EXPERIMENTAL MARINE BIOLOGY AND ECOLOGY = J EXP MAR BIOL ECOL
JOURNAL OF EXPERIMENTAL MEDICINE = J EXP MED
JOURNAL OF EXPERIMENTAL PATHOLOGY = J EXP PATHOL
JOURNAL OF EXPERIMENTAL PSYCHOLOGY-ANIMAL BEHAVIOR PROCESSES = J EXP PSYCHOL ANIM B
JOURNAL OF EXPERIMENTAL PSYCHOLOGY-APPLIED = J EXP PSYCHOL-APPL
JOURNAL OF EXPERIMENTAL PSYCHOLOGY-GENERAL = J EXP PSYCHOL GEN
JOURNAL OF EXPERIMENTAL PSYCHOLOGY-HUMAN PERCEPTION AND PERFORMANCE = J EXP PSYCHOL HUMAN
JOURNAL OF EXPERIMENTAL PSYCHOLOGY-LEARNING MEMORY AND COGNITION = J EXP PSYCHOL LEARN
JOURNAL OF EXPERIMENTAL SOCIAL PSYCHOLOGY = J EXP SOC PSYCHOL
JOURNAL OF EXPERIMENTAL ZOOLOGY = J EXP ZOOL
JOURNAL OF EXPOSURE ANALYSIS AND ENVIRONMENTAL EPIDEMIOLOGY = J EXPO ANAL ENV EPID
JOURNAL OF FAMILY HISTORY = J FAM HIST
JOURNAL OF FAMILY ISSUES = J FAM ISSUES
JOURNAL OF FAMILY PRACTICE = J FAM PRACTICE
JOURNAL OF FAMILY PSYCHOLOGY = J FAM PSYCHOL
JOURNAL OF FAMILY THERAPY = J FAM THER
JOURNAL OF FAMILY VIOLENCE = J FAM VIOLENCE
JOURNAL OF FAMILY WELFARE = J FAM WELFARE
JOURNAL OF FEMINIST STUDIES IN RELIGION = J FEMINIST STUD REL
JOURNAL OF FERMENTATION AND BIOENGINEERING = J FERMENT BIOENG
JOURNAL OF FERMENTATION TECHNOLOGY = J FERMENT BIOENG
JOURNAL OF FERMENTATION TECHNOLOGY = J FERMENT TECHNOL
JOURNAL OF FERROCEMENT-BANGKOK = J FERROCEMENT
JOURNAL OF FERTILIZER ISSUES = J FERT ISSUES
JOURNAL OF FIELD ARCHAEOLOGY = J FIELD ARCHAEOL
JOURNAL OF FIELD ORNITHOLOGY = J FIELD ORNITHOL
JOURNAL OF FILM AND VIDEO = J FILM VIDEO
JOURNAL OF FILM AND VIDEO = J UNIV FILM VIDEO AS
JOURNAL OF FINANCE = J FINANC
JOURNAL OF FINANCIAL AND QUANTITATIVE ANALYSIS = J FINANC QUANT ANAL
JOURNAL OF FINANCIAL ECONOMICS = J FINANC ECON
JOURNAL OF FINANCIAL INTERMEDIATION = J FINANC INTERMED
JOURNAL OF FINANCIAL RESEARCH = J FINANC RES
JOURNAL OF FINANCIAL SERVICES RESEARCH = J FINANC SERV RES
JOURNAL OF FIRE & FLAMMABILITY = J FIRE FLAMMABILITY
JOURNAL OF FIRE RETARDANT CHEMISTRY = J FIRE RETARD CHEM
JOURNAL OF FIRE SCIENCES = J FIRE SCI
JOURNAL OF FISH BIOLOGY = J FISH BIOL
JOURNAL OF FISH DISEASES = J FISH DIS
JOURNAL OF FLUENCY DISORDERS = J FLUENCY DISORD
JOURNAL OF FLUID MECHANICS = J FLUID MECH
JOURNAL OF FLUIDS AND STRUCTURES = J FLUID STRUCT
JOURNAL OF FLUIDS ENGINEERING-TRANSACTIONS OF THE ASME = J FLUID ENG-T ASME
JOURNAL OF FLUORESCENCE = J FLUORESC
JOURNAL OF FLUORINE CHEMISTRY = J FLUORINE CHEM
JOURNAL OF FOLKLORE RESEARCH = J FOLKLORE RES
JOURNAL OF FOOD & NUTRITION = J FOOD NUTR
JOURNAL OF FOOD AND DRUG ANALYSIS = J FOOD DRUG ANAL
JOURNAL OF FOOD BIOCHEMISTRY = J FOOD BIOCHEM
JOURNAL OF FOOD ENGINEERING = J FOOD ENG
JOURNAL OF FOOD LIPIDS = J FOOD LIPIDS
JOURNAL OF FOOD PROCESS ENGINEERING = J FOOD PROCESS ENG
JOURNAL OF FOOD PROCESSING AND PRESERVATION = J FOOD PROCESS PRES
JOURNAL OF FOOD PROTECTION = J FOOD PROTECT
JOURNAL OF FOOD QUALITY = J FOOD QUALITY
JOURNAL OF FOOD SAFETY = J FOOD SAFETY
JOURNAL OF FOOD SCIENCE = J FOOD SCI
JOURNAL OF FOOD SCIENCE AND TECHNOLOGY-MYSORE = J FOOD SCI TECH MYS
JOURNAL OF FOOD TECHNOLOGY = J FOOD TECHNOL
JOURNAL OF FORAMINIFERAL RESEARCH = J FORAMIN RES
JOURNAL OF FORECASTING = J FORECASTING
JOURNAL OF FORENSIC PSYCHIATRY = J FORENSIC PSYCHIATR
JOURNAL OF FORENSIC SCIENCES = J FORENSIC SCI
JOURNAL OF FORESTRY = J FOREST
JOURNAL OF FOURIER ANALYSIS AND APPLICATIONS = J FOURIER ANAL APPL
JOURNAL OF FRESHWATER ECOLOGY = J FRESHWATER ECOL
JOURNAL OF FUNCTIONAL ANALYSIS = J FUNCT ANAL
JOURNAL OF FUSION ENERGY = J FUSION ENERG
JOURNAL OF FUTURES MARKETS = J FUTURES MARKETS
JOURNAL OF GARDEN HISTORY = J GARDEN HIST
JOURNAL OF GASTROENTEROLOGY = J GASTROENTEROL
JOURNAL OF GASTROENTEROLOGY AND HEPATOLOGY = J GASTROEN HEPATOL
JOURNAL OF GASTROINTESTINAL MOTILITY = J GASTROINTEST MOTIL
JOURNAL OF GASTROINTESTINAL SURGERY = J GASTROINTEST SURG
JOURNAL OF GENDER STUDIES = J GENDER STUD
JOURNAL OF GENE MEDICINE = J GENE MED
JOURNAL OF GENERAL AND APPLIED MICROBIOLOGY = J GEN APPL MICROBIOL
JOURNAL OF GENERAL INTERNAL MEDICINE = J GEN INTERN MED
JOURNAL OF GENERAL MICROBIOLOGY = J GEN MICROBIOL
JOURNAL OF GENERAL PHYSIOLOGY = J GEN PHYSIOL
JOURNAL OF GENERAL PSYCHOLOGY = J GEN PSYCHOL
JOURNAL OF GENERAL VIROLOGY = J GEN VIROL
JOURNAL OF GENETIC PSYCHOLOGY = J GENET PSYCHOL
JOURNAL OF GENETICS = J GENET
JOURNAL OF GEOCHEMICAL EXPLORATION = J GEOCHEM EXPLOR
JOURNAL OF GEODESY = J GEODESY
JOURNAL OF GEODYNAMICS = J GEODYN
JOURNAL OF GEOGRAPHY = J GEOGR
JOURNAL OF GEOGRAPHY IN HIGHER EDUCATION = J GEOGR HIGHER EDUC
JOURNAL OF GEOLOGICAL EDUCATION = J GEOL EDUC
JOURNAL OF GEOLOGY = J GEOL
JOURNAL OF GEOMAGNETISM AND GEOELECTRICITY = J GEOMAGN GEOELECTR
JOURNAL OF GEOMETRIC ANALYSIS = J GEOM ANAL
JOURNAL OF GEOMETRY AND PHYSICS = J GEOM PHYS
JOURNAL OF GEOPHYSICAL RESEARCH = J GEOPHYS RES
JOURNAL OF GEOPHYSICAL RESEARCH-ATMOSPHERES = J GEOPHYS RES-ATMOS
JOURNAL OF GEOPHYSICAL RESEARCH-OCEANS = J GEOPHYS RES-OCEANS
JOURNAL OF GEOPHYSICAL RESEARCH-OCEANS AND ATMOSPHERES = J GEOPHYS RES-OC ATM
JOURNAL OF GEOPHYSICAL RESEARCH-PLANETS = J GEOPHYS RES-PLANET
JOURNAL OF GEOPHYSICAL RESEARCH-SOLID EARTH = J GEOPHYS RES-SOL EA
JOURNAL OF GEOPHYSICAL RESEARCH-SOLID EARTH AND PLANETS = J GEOPHYS RES-SOLID
JOURNAL OF GEOPHYSICAL RESEARCH-SPACE PHYSICS = J GEOPHYS RES
JOURNAL OF GEOPHYSICAL RESEARCH-SPACE PHYSICS = J GEOPHYS RES-SPACE
JOURNAL OF GEOPHYSICS-ZEITSCHRIFT FUR GEOPHYSIK = J GEOPHYS-Z GEOPHYS
JOURNAL OF GEOTECHNICAL AND GEOENVIRONMENTAL ENGINEERING = J GEOTECH GEOENVIRON
JOURNAL OF GEOTECHNICAL ENGINEERING-ASCE = J GEOTECH ENG-ASCE
JOURNAL OF GERIATRIC PSYCHIATRY = J GERIATR PSYCHIAT
JOURNAL OF GERIATRIC PSYCHIATRY AND NEUROLOGY = J GERIATR PSYCH NEUR
JOURNAL OF GERONTOLOGICAL SOCIAL WORK = J GERONTOL SOC WORK
JOURNAL OF GLACIOLOGY = J GLACIOL
JOURNAL OF GLASS STUDIES = J GLASS STUD
JOURNAL OF GLAUCOMA = J GLAUCOMA
JOURNAL OF GLOBAL OPTIMIZATION = J GLOBAL OPTIM
JOURNAL OF GOVERNMENT INFORMATION = J GOV INFORM
JOURNAL OF GRAPH THEORY = J GRAPH THEOR
JOURNAL OF GREAT LAKES RESEARCH = J GREAT LAKES RES
JOURNAL OF GROUP THEORY = J GROUP THEORY
JOURNAL OF GUIDANCE CONTROL AND DYNAMICS = J GUID CONTROL DYNAM
JOURNAL OF GYNECOLOGIC SURGERY = J GYNECOL SURG
JOURNAL OF HAND SURGERY-AMERICAN VOLUME = J HAND SURG-AM
JOURNAL OF HAND SURGERY-BRITISH AND EUROPEAN VOLUME = J HAND SURG-BRIT EUR
JOURNAL OF HARD MATERIALS = J HARD MATER
JOURNAL OF HAZARDOUS MATERIALS = J HAZARD MATER
JOURNAL OF HEAD TRAUMA REHABILITATION = J HEAD TRAUMA REHAB
JOURNAL OF HEALTH AND SOCIAL BEHAVIOR = J HEALTH SOC BEHAV
JOURNAL OF HEALTH CARE FOR THE POOR AND UNDERSERVED = J HEALTH CARE POOR U
JOURNAL OF HEALTH COMMUNICATION = J HEALTH COMMUN
JOURNAL OF HEALTH ECONOMICS = J HEALTH ECON
JOURNAL OF HEALTH POLITICS POLICY AND LAW = J HEALTH POLIT POLIC
JOURNAL OF HEALTH SCIENCE = J HEALTH SCI
JOURNAL OF HEALTHCARE MANAGEMENT = J HEALTHC MANAG
JOURNAL OF HEART AND LUNG TRANSPLANTATION = J HEART LUNG TRANSPL
JOURNAL OF HEART TRANSPLANTATION = J HEART TRANSPLANT
JOURNAL OF HEART VALVE DISEASE = J HEART VALVE DIS
JOURNAL OF HEAT RECOVERY SYSTEMS = J HEAT RECOV SYST
JOURNAL OF HEAT TRANSFER-TRANSACTIONS OF THE ASME = J HEAT TRANS-T ASME
JOURNAL OF HELLENIC STUDIES = J HELLENIC STUD
JOURNAL OF HELMINTHOLOGY = J HELMINTHOL
JOURNAL OF HEMATOTHERAPY = J HEMATOTHER
JOURNAL OF HEMATOTHERAPY & STEM CELL RESEARCH = J HEMATOTH STEM CELL
JOURNAL OF HEPATOLOGY = J HEPATOL
JOURNAL OF HEREDITY = J HERED
JOURNAL OF HERPETOLOGY = J HERPETOL
JOURNAL OF HETEROCYCLIC CHEMISTRY = J HETEROCYCLIC CHEM
JOURNAL OF HEURISTICS = J HEURISTICS
JOURNAL OF HIGH ENERGY PHYSICS = J HIGH ENERGY PHYS
JOURNAL OF HIGH RESOLUTION CHROMATOGRAPHY & CHROMATOGRAPHY COMMUNICATIONS = J HIGH RES CHROMATOG
JOURNAL OF HIGH SPEED NETWORKS = J HIGH SPEED NETW
JOURNAL OF HIGHER EDUCATION = J HIGH EDUC
JOURNAL OF HISPANIC PHILOLOGY = J HISPAN PHILOLOGY
JOURNAL OF HISTOCHEMISTRY & CYTOCHEMISTRY = J HISTOCHEM CYTOCHEM
JOURNAL OF HISTORICAL GEOGRAPHY = J HIST GEOGR
JOURNAL OF HISTORICAL SOCIOLOGY = J HIST SOCIOL
JOURNAL OF HISTOTECHNOLOGY = J HISTOTECHNOL
JOURNAL OF HOMOSEXUALITY = J HOMOSEXUAL
JOURNAL OF HORTICULTURAL SCIENCE = J HORTIC SCI
JOURNAL OF HORTICULTURAL SCIENCE & BIOTECHNOLOGY = J HORTIC SCI BIOTECH
JOURNAL OF HOSPITAL INFECTION = J HOSP INFECT
JOURNAL OF HOUSING ECONOMICS = J HOUS ECON
JOURNAL OF HUMAN EVOLUTION = J HUM EVOL
JOURNAL OF HUMAN GENETICS = J HUM GENET
JOURNAL OF HUMAN HYPERTENSION = J HUM HYPERTENS
JOURNAL OF HUMAN MOVEMENT STUDIES = J HUM MOVEMENT STUD
JOURNAL OF HUMAN NUTRITION = J HUM NUTR
JOURNAL OF HUMAN NUTRITION AND DIETETICS = J HUM NUTR DIET
JOURNAL OF HUMAN RESOURCES = J HUM RESOUR
JOURNAL OF HUMAN STRESS = J HUM STRESS
JOURNAL OF HUMAN VIROLOGY = J HUMAN VIROL
JOURNAL OF HUMANISTIC PSYCHOLOGY = J HUMANIST PSYCHOL
JOURNAL OF HYDRAULIC ENGINEERING-ASCE = J HYDRAUL ENG-ASCE
JOURNAL OF HYDRAULIC RESEARCH = J HYDRAUL RES
JOURNAL OF HYDROLOGY = J HYDROL
JOURNAL OF HYGIENE = J HYG-CAMBRIDGE
JOURNAL OF HYGIENE EPIDEMIOLOGY MICROBIOLOGY AND IMMUNOLOGY = J HYG EPID MICROB IM
JOURNAL OF HYPERTENSION = J HYPERTENS
JOURNAL OF IMAGING SCIENCE = J IMAGING SCI
JOURNAL OF IMAGING SCIENCE AND TECHNOLOGY = J IMAGING SCI TECHN
JOURNAL OF IMAGING TECHNOLOGY = J IMAGING TECHNOL
JOURNAL OF IMMUNOASSAY = J IMMUNOASSAY
JOURNAL OF IMMUNOGENETICS = J IMMUNOGENET
JOURNAL OF IMMUNOLOGICAL METHODS = J IMMUNOL METHODS
JOURNAL OF IMMUNOLOGICAL RESEARCH = J IMMUNOL RES
JOURNAL OF IMMUNOLOGY = J IMMUNOL
JOURNAL OF IMMUNOPHARMACOLOGY = J IMMUNOPHARMACOL
JOURNAL OF IMMUNOTHERAPY = J IMMUNOTHER
JOURNAL OF IMPERIAL AND COMMONWEALTH HISTORY = J IMP COMMONW HIST
JOURNAL OF IN VITRO FERTILIZATION AND EMBRYO TRANSFER = J IN VITRO FERTIL EM
JOURNAL OF INCLUSION PHENOMENA = J INCLUSION PHENOM
JOURNAL OF INCLUSION PHENOMENA AND MACROCYCLIC CHEMISTRY = J INCL PHENOM MACRO
JOURNAL OF INCLUSION PHENOMENA AND MOLECULAR RECOGNITION IN CHEMISTRY = J INCLUS PHENOM MOL
JOURNAL OF INDIAN PHILOSOPHY = J INDIAN PHILOS
JOURNAL OF INDO-EUROPEAN STUDIES = J INDO-EUR STUD
JOURNAL OF INDUSTRIAL AND ENGINEERING CHEMISTRY = J IND ENG CHEM
JOURNAL OF INDUSTRIAL ECONOMICS = J IND ECON
JOURNAL OF INDUSTRIAL MICROBIOLOGY = J IND MICROBIOL
JOURNAL OF INDUSTRIAL MICROBIOLOGY & BIOTECHNOLOGY = J IND MICROBIOL BIOT
JOURNAL OF INEQUALITIES AND APPLICATIONS = J INEQUAL APPL
JOURNAL OF INFECTION = J INFECTION
JOURNAL OF INFECTIOUS DISEASES = J INFECT DIS
JOURNAL OF INFLAMMATION = J INFLAMM
JOURNAL OF INFORMATION ETHICS = J INFORM ETHICS
JOURNAL OF INFORMATION RECORDING = J INFORM REC
JOURNAL OF INFORMATION RECORDING MATERIALS = J INFORM REC MATER
JOURNAL OF INFORMATION SCIENCE = J INFORM SCI
JOURNAL OF INFORMATION SCIENCE AND ENGINEERING = J INF SCI ENG
JOURNAL OF INFORMATION STORAGE AND PROCESSING SYSTEMS = J INF STOR PROC SYST
JOURNAL OF INFORMATION TECHNOLOGY = J INFORM TECHNOL
JOURNAL OF INFRARED AND MILLIMETER WAVES = J INFRARED MILLIM W
JOURNAL OF INHERITED METABOLIC DISEASE = J INHERIT METAB DIS
JOURNAL OF INORGANIC & NUCLEAR CHEMISTRY = J INORG NUCL CHEM
JOURNAL OF INORGANIC AND ORGANOMETALLIC POLYMERS = J INORG ORGANOMET P
JOURNAL OF INORGANIC BIOCHEMISTRY = J INORG BIOCHEM
JOURNAL OF INORGANIC MATERIALS = J INORG MATER
JOURNAL OF INSECT BEHAVIOR = J INSECT BEHAV
JOURNAL OF INSECT PHYSIOLOGY = J INSECT PHYSIOL
JOURNAL OF INSTITUTIONAL AND THEORETICAL ECONOMICS-ZEITSCHRIFT FUR DIE GESAMTE STAATSWISSENSCHAFT = J INST THEOR ECON
JOURNAL OF INTEGRAL EQUATIONS = J INTEGRAL EQUAT
JOURNAL OF INTELLECTUAL DISABILITY RESEARCH = J INTELL DISABIL RES
JOURNAL OF INTELLIGENT & FUZZY SYSTEMS = J INTELL FUZZY SYST
JOURNAL OF INTELLIGENT & ROBOTIC SYSTEMS = J INTELL ROBOT SYST
JOURNAL OF INTELLIGENT INFORMATION SYSTEMS = J INTELL INF SYST
JOURNAL OF INTELLIGENT MANUFACTURING = J INTELL MANUF
JOURNAL OF INTELLIGENT MATERIAL SYSTEMS AND STRUCTURES = J INTEL MAT SYST STR
JOURNAL OF INTENSIVE CARE MEDICINE = J INTENSIVE CARE MED
JOURNAL OF INTERAMERICAN STUDIES AND WORLD AFFAIRS = J INTERAM STUD WORLD
JOURNAL OF INTERDISCIPLINARY CYCLE RESEARCH = J INTERDISCIPL CYCLE
JOURNAL OF INTERDISCIPLINARY HISTORY = J INTERDISCIPL HIST
JOURNAL OF INTERFERON AND CYTOKINE RESEARCH = J INTERF CYTOK RES
JOURNAL OF INTERFERON RESEARCH = J INTERFERON RES
JOURNAL OF INTERNAL MEDICINE = J INTERN MED
JOURNAL OF INTERNATIONAL BIOMEDICAL INFORMATION AND DATA-IBID = J INT BIOMED INF DAT
JOURNAL OF INTERNATIONAL BUSINESS STUDIES = J INT BUS STUD
JOURNAL OF INTERNATIONAL ECONOMICS = J INT ECON
JOURNAL OF INTERNATIONAL MARKETING = J INT MARKETING
JOURNAL OF INTERNATIONAL MEDICAL RESEARCH = J INT MED RES
JOURNAL OF INTERNATIONAL MONEY AND FINANCE = J INT MONEY FINANC
JOURNAL OF INTERPERSONAL VIOLENCE = J INTERPERS VIOLENCE
JOURNAL OF INTERVENTIONAL CARDIAC ELECTROPHYSIOLOGY = J INTERV CARD ELECTR
JOURNAL OF INTERVENTIONAL CARDIOLOGY = J INTERV CARDIOL
JOURNAL OF INTERVENTIONAL RADIOLOGY = J INTERVENT RADIOL
JOURNAL OF INVASIVE CARDIOLOGY = J INVASIVE CARDIOL
JOURNAL OF INVERTEBRATE PATHOLOGY = J INVERTEBR PATHOL
JOURNAL OF INVESTIGATIONAL ALLERGOLOGY & CLINICAL IMMUNOLOGY = J INVEST ALLERG CLIN
JOURNAL OF INVESTIGATIVE DERMATOLOGY = J INVEST DERMATOL
JOURNAL OF INVESTIGATIVE DERMATOLOGY SYMPOSIUM PROCEEDINGS = J INVEST DERM SYMP P
JOURNAL OF INVESTIGATIVE MEDICINE = J INVEST MED
JOURNAL OF INVESTIGATIVE SURGERY = J INVEST SURG
JOURNAL OF IRISH LITERATURE = J IRISH LITERATURE
JOURNAL OF IRON AND STEEL RESEARCH INTERNATIONAL = J IRON STEEL RES INT
JOURNAL OF IRRIGATION AND DRAINAGE ENGINEERING-ASCE = J IRRIG DRAIN E-ASCE
JOURNAL OF JAPAN SOCIETY OF LUBRICATION ENGINEERS = J JPN SOC LUBR ENG
JOURNAL OF JAPANESE SOCIETY OF TRIBOLOGISTS = J JPN SOC TRIBOLOGIS
JOURNAL OF JAPANESE STUDIES = J JPN STUD
JOURNAL OF JEWISH STUDIES = J JEWISH STUD
JOURNAL OF JEWISH THOUGHT & PHILOSOPHY = J JEWISH THOUGHT PH
JOURNAL OF KNOT THEORY AND ITS RAMIFICATIONS = J KNOT THEOR RAMIF
JOURNAL OF KOREAN MEDICAL SCIENCE = J KOREAN MED SCI
JOURNAL OF LABELLED COMPOUNDS & RADIOPHARMACEUTICALS = J LABELLED COMPD RAD
JOURNAL OF LABOR ECONOMICS = J LABOR ECON
JOURNAL OF LABOR RESEARCH = J LABOR RES
JOURNAL OF LABORATORY AND CLINICAL MEDICINE = J LAB CLIN MED
JOURNAL OF LANGUAGE AND SOCIAL PSYCHOLOGY = J LANG SOC PSYCHOL
JOURNAL OF LAPAROENDOSCOPIC & ADVANCED SURGICAL TECHNIQUES-PART A = J LAPAROENDOSC ADV A
JOURNAL OF LAPAROENDOSCOPIC SURGERY = J LAPAROENDOSC SURG
JOURNAL OF LARYNGOLOGY AND OTOLOGY = J LARYNGOL OTOL
JOURNAL OF LASER APPLICATIONS = J LASER APPL
JOURNAL OF LATIN AMERICAN STUDIES = J LAT AM STUD
JOURNAL OF LAW & ECONOMICS = J LAW ECON
JOURNAL OF LAW & EDUCATION = J LAW EDUC
JOURNAL OF LAW AND SOCIETY = J LAW SOC
JOURNAL OF LAW ECONOMICS & ORGANIZATION = J LAW ECON ORGAN
JOURNAL OF LAW MEDICINE & ETHICS = J LAW MED ETHICS
JOURNAL OF LEARNING DISABILITIES = J LEARN DISABIL
JOURNAL OF LEARNING DISABILITIES = J LEARN DISABIL-US
JOURNAL OF LEGAL EDUCATION = J LEGAL EDUC
JOURNAL OF LEGAL MEDICINE = J LEGAL MED
JOURNAL OF LEGAL STUDIES = J LEGAL STUD
JOURNAL OF LEISURE RESEARCH = J LEISURE RES
JOURNAL OF LEUKOCYTE BIOLOGY = J LEUKOCYTE BIOL
JOURNAL OF LIBRARIANSHIP AND INFORMATION SCIENCE = J LIBR INF SCI
JOURNAL OF LIBRARY AUTOMATION = J LIBR AUTOMAT
JOURNAL OF LIE THEORY = J LIE THEORY
JOURNAL OF LIFE SCIENCES ROYAL DUBLIN SOCIETY = J LIFE SCI R DUBL S
JOURNAL OF LIGHTWAVE TECHNOLOGY = J LIGHTWAVE TECHNOL
JOURNAL OF LINGUISTICS = J LINGUIST
JOURNAL OF LIPID MEDIATORS = J LIPID MEDIATOR
JOURNAL OF LIPID MEDIATORS AND CELL SIGNALLING = J LIPID MEDIAT CELL
JOURNAL OF LIPID RESEARCH = J LIPID RES
JOURNAL OF LIPOSOME RESEARCH = J LIPOS RES
JOURNAL OF LIPOSOME RESEARCH = J LIPOSOME RES
JOURNAL OF LIQUID CHROMATOGRAPHY = J LIQ CHROMATOGR
JOURNAL OF LIQUID CHROMATOGRAPHY & RELATED TECHNOLOGIES = J LIQ CHROMATOGR R T
JOURNAL OF LITERACY RESEARCH = J LIT RES
JOURNAL OF LITERARY SEMANTICS = J LITERARY SEMANTICS
JOURNAL OF LITHOTRIPSY & STONE DISEASE = J LITHOTR STONE DIS
JOURNAL OF LOGIC AND COMPUTATION = J LOGIC COMPUT
JOURNAL OF LOGIC PROGRAMMING = J LOGIC PROGRAM
JOURNAL OF LONG-TERM EFFECTS OF MEDICAL IMPLANTS = J LONG-TERM EFF MED
JOURNAL OF LOSS PREVENTION IN THE PROCESS INDUSTRIES = J LOSS PREVENT PROC
JOURNAL OF LOW FREQUENCY NOISE & VIBRATION = J LOW FREQ NOISE VIB
JOURNAL OF LOW FREQUENCY NOISE VIBRATION AND ACTIVE CONTROL = J LOW FREQ NOISE V A
JOURNAL OF LOW TEMPERATURE PHYSICS = J LOW TEMP PHYS
JOURNAL OF LUBRICATION TECHNOLOGY-TRANSACTIONS OF THE ASME = J LUBRIC TECH-T ASME
JOURNAL OF LUMINESCENCE = J LUMIN
JOURNAL OF MACROECONOMICS = J MACROECON
JOURNAL OF MACROMOLECULAR SCIENCE-CHEMISTRY = J MACROMOL SCI CHEM
JOURNAL OF MACROMOLECULAR SCIENCE-PHYSICS = J MACROMOL SCI PHYS
JOURNAL OF MACROMOLECULAR SCIENCE-PURE AND APPLIED CHEMISTRY = J MACROMOL SCI PURE
JOURNAL OF MACROMOLECULAR SCIENCE-REVIEWS IN MACROMOLECULAR CHEMISTRY AND PHYSICS = J MACROMOL SCI R M C
JOURNAL OF MAGNETIC RESONANCE = J MAGN RESON
JOURNAL OF MAGNETIC RESONANCE SERIES A = J MAGN RESON SER A
JOURNAL OF MAGNETIC RESONANCE SERIES B = J MAGN RESON SER B
JOURNAL OF MAGNETISM AND MAGNETIC MATERIALS = J MAGN MAGN MATER
JOURNAL OF MAMMALOGY = J MAMMAL
JOURNAL OF MAMMARY GLAND BIOLOGY AND NEOPLASIA = J MAMMARY GLAND BIOL
JOURNAL OF MANAGEMENT = J MANAGE
JOURNAL OF MANAGEMENT IN ENGINEERING = J MANAGE ENG
JOURNAL OF MANAGEMENT INFORMATION SYSTEMS = J MANAGE INFORM SYST
JOURNAL OF MANAGEMENT INQUIRY = J MANAGE INQUIRY
JOURNAL OF MANAGEMENT STUDIES = J MANAGE STUD
JOURNAL OF MANIPULATIVE AND PHYSIOLOGICAL THERAPEUTICS = J MANIP PHYSIOL THER
JOURNAL OF MANUFACTURING = J MANUF
JOURNAL OF MANUFACTURING SCIENCE AND ENGINEERING-TRANSACTIONS OF THE ASME = J MANUF SCI E-T ASME
JOURNAL OF MANUFACTURING SYSTEMS = J MANUF SYST
JOURNAL OF MARINE BIOTECHNOLOGY = J MAR BIOTECHNOL
JOURNAL OF MARINE RESEARCH = J MAR RES
JOURNAL OF MARINE SYSTEMS = J MARINE SYST
JOURNAL OF MARITAL AND FAMILY THERAPY = J MARITAL FAM THER
JOURNAL OF MARITIME LAW AND COMMERCE = J MARIT LAW COMMER
JOURNAL OF MARKETING = J MARKETING
JOURNAL OF MARKETING RESEARCH = J MARKETING RES
JOURNAL OF MARRIAGE AND THE FAMILY = J MARRIAGE FAM
JOURNAL OF MASS SPECTROMETRY = J MASS SPECTROM
JOURNAL OF MATERIAL CULTURE = J MAT CULT
JOURNAL OF MATERIALS CHEMISTRY = J MATER CHEM
JOURNAL OF MATERIALS ENGINEERING = J MATER ENG
JOURNAL OF MATERIALS ENGINEERING AND PERFORMANCE = J MATER ENG PERFORM
JOURNAL OF MATERIALS FOR ENERGY SYSTEMS = J MATER ENG
JOURNAL OF MATERIALS IN CIVIL ENGINEERING = J MATER CIVIL ENG
JOURNAL OF MATERIALS PROCESSING & MANUFACTURING SCIENCE = J MATER PROCESS MANU
JOURNAL OF MATERIALS PROCESSING TECHNOLOGY = J MATER PROCESS TECH
JOURNAL OF MATERIALS RESEARCH = J MATER RES
JOURNAL OF MATERIALS SCIENCE = J MATER SCI
JOURNAL OF MATERIALS SCIENCE & TECHNOLOGY = J MATER SCI TECHNOL
JOURNAL OF MATERIALS SCIENCE LETTERS = J MATER SCI LETT
JOURNAL OF MATERIALS SCIENCE-MATERIALS IN ELECTRONICS = J MATER SCI-MATER EL
JOURNAL OF MATERIALS SCIENCE-MATERIALS IN MEDICINE = J MATER SCI-MATER M
JOURNAL OF MATERIALS SYNTHESIS AND PROCESSING = J MATER SYNTH PROCES
JOURNAL OF MATERNAL-FETAL INVESTIGATION = J MATERN-FETAL INVES
JOURNAL OF MATHEMATICAL ANALYSIS AND APPLICATIONS = J MATH ANAL APPL
JOURNAL OF MATHEMATICAL BIOLOGY = J MATH BIOL
JOURNAL OF MATHEMATICAL CHEMISTRY = J MATH CHEM
JOURNAL OF MATHEMATICAL ECONOMICS = J MATH ECON
JOURNAL OF MATHEMATICAL IMAGING AND VISION = J MATH IMAGING VIS
JOURNAL OF MATHEMATICAL PHYSICS = J MATH PHYS
JOURNAL OF MATHEMATICAL PSYCHOLOGY = J MATH PSYCHOL
JOURNAL OF MATHEMATICAL SOCIOLOGY = J MATH SOCIOL
JOURNAL OF MATHEMATICS OF KYOTO UNIVERSITY = J MATH KYOTO U
JOURNAL OF MAXILLOFACIAL SURGERY = J MAXILLOFAC SURG
JOURNAL OF MECHANICAL DESIGN = J MECH DESIGN
JOURNAL OF MECHANICAL DESIGN-TRANSACTIONS OF THE ASME = J MECH DES-T ASME
JOURNAL OF MECHANICAL ENGINEERING LABORATORY = J MECH ENG LAB
JOURNAL OF MECHANICAL ENGINEERING SCIENCE = J MECH ENG SCI
JOURNAL OF MECHANICAL WORKING TECHNOLOGY = J MECH WORK TECHNOL
JOURNAL OF MECHANISMS TRANSMISSIONS AND AUTOMATION IN DESIGN-TRANSACTIONS OF THE ASME = J MECH TRANSM-T ASME
JOURNAL OF MEDIA ECONOMICS = J MEDIA ECON
JOURNAL OF MEDICAL AND VETERINARY MYCOLOGY = J MED VET MYCOL
JOURNAL OF MEDICAL EDUCATION = J MED EDUC
JOURNAL OF MEDICAL ENGINEERING & TECHNOLOGY = J MED ENG TECHNOL
JOURNAL OF MEDICAL ENTOMOLOGY = J MED ENTOMOL
JOURNAL OF MEDICAL ETHICS = J MED ETHICS
JOURNAL OF MEDICAL GENETICS = J MED GENET
JOURNAL OF MEDICAL MICROBIOLOGY = J MED MICROBIOL
JOURNAL OF MEDICAL PRIMATOLOGY = J MED PRIMATOL
JOURNAL OF MEDICAL SCREENING = J MED SCREEN
JOURNAL OF MEDICAL SPEECH-LANGUAGE PATHOLOGY = J MED SPEECH-LANG PA
JOURNAL OF MEDICAL SYSTEMS = J MED SYST
JOURNAL OF MEDICAL TECHNOLOGY = J MED TECHNOL
JOURNAL OF MEDICAL VIROLOGY = J MED VIROL
JOURNAL OF MEDICINAL CHEMISTRY = J MED CHEM
JOURNAL OF MEDICINE = J MED
JOURNAL OF MEDICINE AND PHILOSOPHY = J MED PHILOS
JOURNAL OF MEDIEVAL AND EARLY MODERN STUDIES = J MEDIEV EARLY MOD S
JOURNAL OF MEDIEVAL AND RENAISSANCE STUDIES = J MEDIEVAL RENAISS
JOURNAL OF MEDIEVAL HISTORY = J MEDIEVAL HIST
JOURNAL OF MEDITERRANEAN STUDIES = J MEDITERR STUD
JOURNAL OF MEMBRANE BIOLOGY = J MEMBRANE BIOL
JOURNAL OF MEMBRANE SCIENCE = J MEMBRANE SCI
JOURNAL OF MEMORY AND LANGUAGE = J MEM LANG
JOURNAL OF MENTAL DEFICIENCY RESEARCH = J MENT DEFIC RES
JOURNAL OF MENTAL HEALTH ADMINISTRATION = J MENT HEALTH ADMIN
JOURNAL OF METALS = JOM-J MIN MET MAT S
JOURNAL OF METAMORPHIC GEOLOGY = J METAMORPH GEOL
JOURNAL OF MICROBIAL BIOTECHNOLOGY = J MICROBIAL BIOTECH
JOURNAL OF MICROBIOLOGICAL METHODS = J MICROBIOL METH
JOURNAL OF MICROBIOLOGY = J MICROBIOL
JOURNAL OF MICROBIOLOGY AND BIOTECHNOLOGY = J MICROBIOL BIOTECHN
JOURNAL OF MICROCOLUMN SEPARATIONS = J MICROCOLUMN SEP
JOURNAL OF MICROCOMPUTER APPLICATIONS = J MICROCOMPUT APPL
JOURNAL OF MICROELECTROMECHANICAL SYSTEMS = J MICROELECTROMECH S
JOURNAL OF MICROENCAPSULATION = J MICROENCAPSUL
JOURNAL OF MICROMECHANICS AND MICROENGINEERING = J MICROMECH MICROENG
JOURNAL OF MICRONUTRIENT ANALYSIS = J MICRONUTR ANAL
JOURNAL OF MICROPALAEONTOLOGY = J MICROPALAEONTOL
JOURNAL OF MICROSCOPY-OXFORD = J MICROSC-OXFORD
JOURNAL OF MICROWAVE POWER AND ELECTROMAGNETIC ENERGY = J MICROWAVE POWER EE
JOURNAL OF MIDWIFERY & WOMENS HEALTH = J MIDWIFERY WOM HEAL
JOURNAL OF MILITARY HISTORY = J MILITARY HIST
JOURNAL OF MIND AND BEHAVIOR = J MIND BEHAV
JOURNAL OF MINING SCIENCE = J MIN SCI+
JOURNAL OF MODERN AFRICAN STUDIES = J MOD AFR STUD
JOURNAL OF MODERN GREEK STUDIES = J MOD GREEK STUD
JOURNAL OF MODERN HISTORY = J MOD HIST
JOURNAL OF MODERN ITALIAN STUDIES = J MOD ITAL STUD
JOURNAL OF MODERN LITERATURE = J MOD LITERATURE
JOURNAL OF MODERN OPTICS = J MOD OPTIC
JOURNAL OF MOLECULAR AND APPLIED GENETICS = J MOL APPL GENET
JOURNAL OF MOLECULAR AND CELLULAR CARDIOLOGY = J MOL CELL CARDIOL
JOURNAL OF MOLECULAR AND CELLULAR IMMUNOLOGY = J MOL CELL IMMUNOL
JOURNAL OF MOLECULAR BIOLOGY = J MOL BIOL
JOURNAL OF MOLECULAR CATALYSIS = J MOL CATAL
JOURNAL OF MOLECULAR CATALYSIS A-CHEMICAL = J MOL CATAL A-CHEM
JOURNAL OF MOLECULAR CATALYSIS B-ENZYMATIC = J MOL CATAL B-ENZYM
JOURNAL OF MOLECULAR ELECTRONICS = J MOL ELECTRON
JOURNAL OF MOLECULAR ENDOCRINOLOGY = J MOL ENDOCRINOL
JOURNAL OF MOLECULAR EVOLUTION = J MOL EVOL
JOURNAL OF MOLECULAR GRAPHICS = J MOL GRAPHICS
JOURNAL OF MOLECULAR GRAPHICS & MODELLING = J MOL GRAPH MODEL
JOURNAL OF MOLECULAR LIQUIDS = J MOL LIQ
JOURNAL OF MOLECULAR MEDICINE-JMM = J MOL MED-JMM
JOURNAL OF MOLECULAR MODELING = J MOL MODEL
JOURNAL OF MOLECULAR NEUROSCIENCE = J MOL NEUROSCI
JOURNAL OF MOLECULAR RECOGNITION = J MOL RECOGNIT
JOURNAL OF MOLECULAR SPECTROSCOPY = J MOL SPECTROSC
JOURNAL OF MOLECULAR STRUCTURE = J MOL STRUCT
JOURNAL OF MOLECULAR STRUCTURE-THEOCHEM = J MOL STRUC-THEOCHEM
JOURNAL OF MOLLUSCAN STUDIES = J MOLLUS STUD
JOURNAL OF MONETARY ECONOMICS = J MONETARY ECON
JOURNAL OF MONEY CREDIT AND BANKING = J MONEY CREDIT BANK
JOURNAL OF MORAL EDUCATION = J MORAL EDUC
JOURNAL OF MORPHOLOGY = J MORPHOL
JOURNAL OF MOTOR BEHAVIOR = J MOTOR BEHAV
JOURNAL OF MULTICULTURAL COUNSELING AND DEVELOPMENT = J MULTICULT COUNS D
JOURNAL OF MULTIVARIATE ANALYSIS = J MULTIVARIATE ANAL
JOURNAL OF MUSCLE FOODS = J MUSCLE FOODS
JOURNAL OF MUSCLE RESEARCH AND CELL MOTILITY = J MUSCLE RES CELL M
JOURNAL OF MUSCULOSKELETAL PAIN = J MUSCULOSKELET PAIN
JOURNAL OF MUSIC THEORY = J MUSIC THEORY
JOURNAL OF MUSIC THERAPY = J MUSIC THER
JOURNAL OF MUSICOLOGICAL RESEARCH = J MUSICOL RES
JOURNAL OF MUSICOLOGY = J MUSICOLOGY
JOURNAL OF NARRATIVE AND LIFE HISTORY = J NARRAT LIFE HIST
JOURNAL OF NARRATIVE TECHNIQUE = J NARRATIVE TECH
JOURNAL OF NATURAL HISTORY = J NAT HIST
JOURNAL OF NATURAL PRODUCTS = J NAT PROD
JOURNAL OF NATURAL PRODUCTS-LLOYDIA = J NAT PRODUCTS
JOURNAL OF NATURAL TOXINS = J NAT TOXINS
JOURNAL OF NAVIGATION = J NAVIGATION
JOURNAL OF NEAR EASTERN STUDIES = J NEAR EASTERN STUD
JOURNAL OF NEAR INFRARED SPECTROSCOPY = J NEAR INFRARED SPEC
JOURNAL OF NEGRO EDUCATION = J NEGRO EDUC
JOURNAL OF NEMATOLOGY = J NEMATOL
JOURNAL OF NEPHROLOGY = J NEPHROL
JOURNAL OF NERVOUS AND MENTAL DISEASE = J NERV MENT DIS
JOURNAL OF NETWORK AND COMPUTER APPLICATIONS = J NETW COMPUT APPL
JOURNAL OF NEURAL TRANSMISSION = J NEURAL TRANSM
JOURNAL OF NEURAL TRANSMISSION-GENERAL SECTION = J NEURAL TRANSM-GEN
JOURNAL OF NEURAL TRANSMISSION-PARKINSONS DISEASE AND DEMENTIA SECTION = J NEURAL TRANSM-PARK
JOURNAL OF NEURAL TRANSMISSION-SUPPLEMENT = J NEURAL TRANSM-SUPP
JOURNAL OF NEURAL TRANSPLANTATION & PLASTICITY = J NEURAL TRANSP PLAS
JOURNAL OF NEURO-ONCOLOGY = J NEURO-ONCOL
JOURNAL OF NEURO-OPHTHALMOLOGY = J NEURO-OPHTHALMOL
JOURNAL OF NEUROBIOLOGY = J NEUROBIOL
JOURNAL OF NEUROCHEMISTRY = J NEUROCHEM
JOURNAL OF NEUROCYTOLOGY = J NEUROCYTOL
JOURNAL OF NEUROENDOCRINOLOGY = J NEUROENDOCRINOL
JOURNAL OF NEUROGENETICS = J NEUROGENET
JOURNAL OF NEUROIMAGING = J NEUROIMAGING
JOURNAL OF NEUROIMMUNOLOGY = J NEUROIMMUNOL
JOURNAL OF NEUROLINGUISTICS = J NEUROLINGUIST
JOURNAL OF NEUROLOGIC REHABILITATION = J NEUROL REHABIL
JOURNAL OF NEUROLOGICAL AND ORTHOPAEDIC MEDICINE AND SURGERY = J NEUROL ORTH MED S
JOURNAL OF NEUROLOGY = J NEUROL
JOURNAL OF NEUROLOGY NEUROSURGERY AND PSYCHIATRY = J NEUROL NEUROSUR PS
JOURNAL OF NEUROPATHOLOGY AND EXPERIMENTAL NEUROLOGY = J NEUROPATH EXP NEUR
JOURNAL OF NEUROPHYSIOLOGY = J NEUROPHYSIOL
JOURNAL OF NEUROPSYCHIATRY AND CLINICAL NEUROSCIENCES = J NEUROPSYCH CLIN N
JOURNAL OF NEURORADIOLOGY = J NEURORADIOLOGY
JOURNAL OF NEUROSCIENCE = J NEUROSCI
JOURNAL OF NEUROSCIENCE METHODS = J NEUROSCI METH
JOURNAL OF NEUROSCIENCE RESEARCH = J NEUROSCI RES
JOURNAL OF NEUROSURGERY = J NEUROSURG
JOURNAL OF NEUROSURGICAL ANESTHESIOLOGY = J NEUROSURG ANESTH
JOURNAL OF NEUROTRAUMA = J NEUROTRAUM
JOURNAL OF NEUROVIROLOGY = J NEUROVIROL
JOURNAL OF NEW MATERIALS FOR ELECTROCHEMICAL SYSTEMS = J NEW MAT ELECT SYST
JOURNAL OF NEW MUSIC RESEARCH = J NEW MUSIC RES
JOURNAL OF NON-CRYSTALLINE SOLIDS = J NON-CRYST SOLIDS
JOURNAL OF NON-EQUILIBRIUM THERMODYNAMICS = J NON-EQUIL THERMODY
JOURNAL OF NON-NEWTONIAN FLUID MECHANICS = J NON-NEWTON FLUID
JOURNAL OF NONDESTRUCTIVE EVALUATION = J NONDESTRUCT EVAL
JOURNAL OF NONLINEAR MATHEMATICAL PHYSICS = J NONLINEAR MATH PHY
JOURNAL OF NONLINEAR OPTICAL PHYSICS & MATERIALS = J NONLINEAR OPT PHYS
JOURNAL OF NONLINEAR SCIENCE = J NONLINEAR SCI
JOURNAL OF NONPARAMETRIC STATISTICS = J NONPARAMETR STAT
JOURNAL OF NONVERBAL BEHAVIOR = J NONVERBAL BEHAV
JOURNAL OF NUCLEAR CARDIOLOGY = J NUCL CARDIOL
JOURNAL OF NUCLEAR MATERIALS = J NUCL MATER
JOURNAL OF NUCLEAR MEDICINE = J NUCL MED
JOURNAL OF NUCLEAR MEDICINE AND ALLIED SCIENCES = J NUCL MED ALLIED S
JOURNAL OF NUCLEAR SCIENCE AND TECHNOLOGY = J NUCL SCI TECHNOL
JOURNAL OF NUMBER THEORY = J NUMBER THEORY
JOURNAL OF NURSE-MIDWIFERY = J NURSE-MIDWIFERY
JOURNAL OF NURSING ADMINISTRATION = J NURS ADMIN
JOURNAL OF NURSING CARE QUALITY = J NURS CARE QUAL
JOURNAL OF NURSING EDUCATION = J NURS EDUC
JOURNAL OF NURSING SCHOLARSHIP = J NURS SCHOLARSHIP
JOURNAL OF NUTRITION = J NUTR
JOURNAL OF NUTRITION EDUCATION = J NUTR EDUC
JOURNAL OF NUTRITIONAL BIOCHEMISTRY = J NUTR BIOCHEM
JOURNAL OF NUTRITIONAL SCIENCE AND VITAMINOLOGY = J NUTR SCI VITAMINOL
JOURNAL OF OBJECT-ORIENTED PROGRAMMING = J OBJECT-ORIENT PROG
JOURNAL OF OBSTETRICS AND GYNAECOLOGY = J OBSTET GYNAECOL
JOURNAL OF OCCUPATIONAL ACCIDENTS = J OCCUP ACCID
JOURNAL OF OCCUPATIONAL AND ENVIRONMENTAL MEDICINE = J OCCUP ENVIRON MED
JOURNAL OF OCCUPATIONAL AND ORGANIZATIONAL PSYCHOLOGY = J OCCUP ORGAN PSYCH
JOURNAL OF OCCUPATIONAL HEALTH = J OCCUP HEALTH
JOURNAL OF OCCUPATIONAL REHABILITATION = J OCCUP REHABIL
JOURNAL OF OCULAR PHARMACOLOGY = J OCUL PHARMACOL
JOURNAL OF OCULAR PHARMACOLOGY AND THERAPEUTICS = J OCUL PHARMACOL TH
JOURNAL OF OFFSHORE MECHANICS AND ARCTIC ENGINEERING-TRANSACTIONS OF THE ASME = J OFFSHORE MECH ARCT
JOURNAL OF OPERATIONS MANAGEMENT = J OPER MANAG
JOURNAL OF OPERATOR THEORY = J OPERAT THEOR
JOURNAL OF OPTICAL TECHNOLOGY = J OPT TECHNOL+
JOURNAL OF OPTICS A-PURE AND APPLIED OPTICS = J OPT A-PURE APPL OP
JOURNAL OF OPTICS B-QUANTUM AND SEMICLASSICAL OPTICS = J OPT B-QUANTUM S O
JOURNAL OF OPTICS-NOUVELLE REVUE D OPTIQUE = J OPT
JOURNAL OF OPTIMIZATION THEORY AND APPLICATIONS = J OPTIMIZ THEORY APP
JOURNAL OF OPTOELECTRONICS AND ADVANCED MATERIALS = J OPTOELECTRON ADV M
JOURNAL OF ORAL AND MAXILLOFACIAL SURGERY = J ORAL MAXIL SURG
JOURNAL OF ORAL PATHOLOGY & MEDICINE = J ORAL PATHOL MED
JOURNAL OF ORAL REHABILITATION = J ORAL REHABIL
JOURNAL OF ORAL SURGERY = J ORAL SURG
JOURNAL OF ORGANIC CHEMISTRY = J ORG CHEM
JOURNAL OF ORGANIZATIONAL BEHAVIOR = J ORGAN BEHAV
JOURNAL OF ORGANIZATIONAL BEHAVIOR MANAGEMENT = J ORGAN BEHAV MANAGE
JOURNAL OF ORGANIZATIONAL CHANGE MANAGEMENT = J ORGAN CHANGE MANAG
JOURNAL OF ORGANIZATIONAL COMPUTING AND ELECTRONIC COMMERCE = J ORG COMP ELECT COM
JOURNAL OF ORGANOMETALLIC CHEMISTRY = J ORGANOMET CHEM
JOURNAL OF OROFACIAL PAIN = J OROFAC PAIN
JOURNAL OF ORTHOMOLECULAR MEDICINE = J ORTHOMOL MED
JOURNAL OF ORTHOMOLECULAR PSYCHIATRY = J ORTHOMOL MED
JOURNAL OF ORTHOPAEDIC & SPORTS PHYSICAL THERAPY = J ORTHOP SPORT PHYS
JOURNAL OF ORTHOPAEDIC RESEARCH = J ORTHOPAED RES
JOURNAL OF ORTHOPAEDIC RHEUMATOLOGY = J ORTHOP RHEUMATOL
JOURNAL OF ORTHOPAEDIC TRAUMA = J ORTHOP TRAUMA
JOURNAL OF OTOLARYNGOLOGY = J OTOLARYNGOL
JOURNAL OF PACIFIC HISTORY = J PAC HIST
JOURNAL OF PAEDIATRICS AND CHILD HEALTH = J PAEDIATR CHILD H
JOURNAL OF PAIN AND SYMPTOM MANAGEMENT = J PAIN SYMPTOM MANAG
JOURNAL OF PALEOLIMNOLOGY = J PALEOLIMNOL
JOURNAL OF PALEONTOLOGY = J PALEONTOL
JOURNAL OF PALESTINE STUDIES = J PALESTINE STUD
JOURNAL OF PALLIATIVE CARE = J PALLIATIVE CARE
JOURNAL OF PARALLEL AND DISTRIBUTED COMPUTING = J PARALLEL DISTR COM
JOURNAL OF PARAPSYCHOLOGY = J PARAPSYCHOL
JOURNAL OF PARASITOLOGY = J PARASITOL
JOURNAL OF PARENTERAL AND ENTERAL NUTRITION = JPEN-PARENTER ENTER
JOURNAL OF PARENTERAL SCIENCE AND TECHNOLOGY = J PARENT SCI TECHN
JOURNAL OF PATHOLOGY = J PATHOL
JOURNAL OF PEACE RESEARCH = J PEACE RES
JOURNAL OF PEASANT STUDIES = J PEASANT STUD
JOURNAL OF PEDIATRIC ENDOCRINOLOGY = J PEDIATR ENDOCRINOL
JOURNAL OF PEDIATRIC ENDOCRINOLOGY & METABOLISM = J PEDIATR ENDOCR MET
JOURNAL OF PEDIATRIC GASTROENTEROLOGY AND NUTRITION = J PEDIATR GASTR NUTR
JOURNAL OF PEDIATRIC HEMATOLOGY ONCOLOGY = J PEDIAT HEMATOL ONC
JOURNAL OF PEDIATRIC OPHTHALMOLOGY & STRABISMUS = J PEDIAT OPHTH STRAB
JOURNAL OF PEDIATRIC OPHTHALMOLOGY & STRABISMUS = J PEDIATR OPHTHALMOL
JOURNAL OF PEDIATRIC ORTHOPAEDICS = J PEDIATR ORTHOPED
JOURNAL OF PEDIATRIC ORTHOPAEDICS-PART B = J PEDIATR ORTHOP B
JOURNAL OF PEDIATRIC PSYCHOLOGY = J PEDIATR PSYCHOL
JOURNAL OF PEDIATRIC SURGERY = J PEDIATR SURG
JOURNAL OF PEDIATRICS = J PEDIATR
JOURNAL OF PEPTIDE RESEARCH = J PEPT RES
JOURNAL OF PEPTIDE SCIENCE = J PEPT SCI
JOURNAL OF PERINATAL & NEONATAL NURSING = J PERINAT NEONAT NUR
JOURNAL OF PERINATAL MEDICINE = J PERINAT MED
JOURNAL OF PERIODONTAL RESEARCH = J PERIODONTAL RES
JOURNAL OF PERIODONTOLOGY = J PERIODONTOL
JOURNAL OF PERSONAL & INTERPERSONAL LOSS = J PERS INTERPERS LOS
JOURNAL OF PERSONALITY = J PERS
JOURNAL OF PERSONALITY AND SOCIAL PSYCHOLOGY = J PERS SOC PSYCHOL
JOURNAL OF PERSONALITY ASSESSMENT = J PERS ASSESS
JOURNAL OF PERSONALITY DISORDERS = J PERS DISORD
JOURNAL OF PESTICIDE SCIENCE = J PESTIC SCI
JOURNAL OF PETROLEUM GEOLOGY = J PETROL GEOL
JOURNAL OF PETROLEUM SCIENCE AND ENGINEERING = J PETROL SCI ENG
JOURNAL OF PETROLEUM TECHNOLOGY = J PETROL TECHNOL
JOURNAL OF PETROLOGY = J PETROL
JOURNAL OF PHARMACEUTICAL AND BIOMEDICAL ANALYSIS = J PHARMACEUT BIOMED
JOURNAL OF PHARMACEUTICAL SCIENCES = J PHARM SCI
JOURNAL OF PHARMACOBIO-DYNAMICS = J PHARMACOBIO-DYNAM
JOURNAL OF PHARMACOKINETICS AND BIOPHARMACEUTICS = J PHARMACOKINET BIOP
JOURNAL OF PHARMACOLOGICAL AND TOXICOLOGICAL METHODS = J PHARMACOL TOXICOL
JOURNAL OF PHARMACOLOGICAL METHODS = J PHARMACOL METHOD
JOURNAL OF PHARMACOLOGY AND EXPERIMENTAL THERAPEUTICS = J PHARMACOL EXP THER
JOURNAL OF PHARMACY AND PHARMACEUTICAL SCIENCES = J PHARM PHARM SCI
JOURNAL OF PHARMACY AND PHARMACOLOGY = J PHARM PHARMACOL
JOURNAL OF PHASE EQUILIBRIA = J PHASE EQUILIB
JOURNAL OF PHENOMENOLOGICAL PSYCHOLOGY = J PHENOMENOL PSYCHOL
JOURNAL OF PHILOSOPHICAL LOGIC = J PHILOS LOGIC
JOURNAL OF PHILOSOPHY = J PHILOS
JOURNAL OF PHILOSOPHY OF EDUCATION = J PHILOS EDUC
JOURNAL OF PHONETICS = J PHONETICS
JOURNAL OF PHOTOCHEMISTRY = J PHOTOCHEM
JOURNAL OF PHOTOCHEMISTRY AND PHOTOBIOLOGY A-CHEMISTRY = J PHOTOCH PHOTOBIO A
JOURNAL OF PHOTOCHEMISTRY AND PHOTOBIOLOGY B-BIOLOGY = J PHOTOCH PHOTOBIO B
JOURNAL OF PHOTOGRAPHIC SCIENCE = J PHOTOGR SCI
JOURNAL OF PHYCOLOGY = J PHYCOL
JOURNAL OF PHYSICAL AND CHEMICAL REFERENCE DATA = J PHYS CHEM REF DATA
JOURNAL OF PHYSICAL CHEMISTRY = J PHYS CHEM-US
JOURNAL OF PHYSICAL CHEMISTRY A = J PHYS CHEM A
JOURNAL OF PHYSICAL CHEMISTRY B = J PHYS CHEM B
JOURNAL OF PHYSICAL OCEANOGRAPHY = J PHYS OCEANOGR
JOURNAL OF PHYSICAL ORGANIC CHEMISTRY = J PHYS ORG CHEM
JOURNAL OF PHYSICS A-MATHEMATICAL AND GENERAL = J PHYS A-MATH GEN
JOURNAL OF PHYSICS AND CHEMISTRY OF SOLIDS = J PHYS CHEM SOLIDS
JOURNAL OF PHYSICS B-ATOMIC MOLECULAR AND OPTICAL PHYSICS = J PHYS B-AT MOL OPT
JOURNAL OF PHYSICS C-SOLID STATE PHYSICS = J PHYS C SOLID STATE
JOURNAL OF PHYSICS D-APPLIED PHYSICS = J PHYS D APPL PHYS
JOURNAL OF PHYSICS E-SCIENTIFIC INSTRUMENTS = J PHYS E SCI INSTRUM
JOURNAL OF PHYSICS F-METAL PHYSICS = J PHYS F MET PHYS
JOURNAL OF PHYSICS G-NUCLEAR AND PARTICLE PHYSICS = J PHYS G NUCL PARTIC
JOURNAL OF PHYSICS OF THE EARTH = J PHYS EARTH
JOURNAL OF PHYSICS-CONDENSED MATTER = J PHYS-CONDENS MAT
JOURNAL OF PHYSIOLOGY AND BIOCHEMISTRY = J PHYSIOL BIOCHEM
JOURNAL OF PHYSIOLOGY AND PHARMACOLOGY = J PHYSIOL PHARMACOL
JOURNAL OF PHYSIOLOGY-LONDON = J PHYSIOL-LONDON
JOURNAL OF PHYSIOLOGY-PARIS = J PHYSIOLOGY-PARIS
JOURNAL OF PHYTOPATHOLOGY-PHYTOPATHOLOGISCHE ZEITSCHRIFT = J PHYTOPATHOL
JOURNAL OF PIDGIN AND CREOLE LANGUAGES = J PIDGIN CREOLE LANG
JOURNAL OF PINEAL RESEARCH = J PINEAL RES
JOURNAL OF PIPELINES = J PIPELINE
JOURNAL OF PLANKTON RESEARCH = J PLANKTON RES
JOURNAL OF PLANNING EDUCATION AND RESEARCH = J PLAN EDUC RES
JOURNAL OF PLANT BIOCHEMISTRY AND BIOTECHNOLOGY = J PLANT BIOCHEM BIOT
JOURNAL OF PLANT GROWTH REGULATION = J PLANT GROWTH REGUL
JOURNAL OF PLANT NUTRITION = J PLANT NUTR
JOURNAL OF PLANT NUTRITION AND SOIL SCIENCE-ZEITSCHRIFT FUR PFLANZENERNAHRUNG UND BODENKUNDE = J PLANT NUTR SOIL SC
JOURNAL OF PLANT PHYSIOLOGY = J PLANT PHYSIOL
JOURNAL OF PLANT RESEARCH = J PLANT RES
JOURNAL OF PLANTATION CROPS = J PLANTATION CROPS
JOURNAL OF PLASMA PHYSICS = J PLASMA PHYS
JOURNAL OF PLASTIC FILM & SHEETING = J PLAST FILM SHEET
JOURNAL OF POLICY ANALYSIS AND MANAGEMENT = J POLICY ANAL MANAG
JOURNAL OF POLICY MODELING = J POLICY MODEL
JOURNAL OF POLITICAL & MILITARY SOCIOLOGY = J POLIT MIL SOCIOL
JOURNAL OF POLITICAL ECONOMY = J POLIT ECON
JOURNAL OF POLITICAL PHILOSOPHY = J POLIT PHILOS
JOURNAL OF POLITICS = J POLIT
JOURNAL OF POLYMER ENGINEERING = J POLYM ENG
JOURNAL OF POLYMER MATERIALS = J POLYM MATER
JOURNAL OF POLYMER RESEARCH-TAIWAN = J POLYM RES-TAIWAN
JOURNAL OF POLYMER SCIENCE PART A-POLYMER CHEMISTRY = J POLYM SCI POL CHEM
JOURNAL OF POLYMER SCIENCE PART B-POLYMER PHYSICS = J POLYM SCI POL PHYS
JOURNAL OF POLYMER SCIENCE PART C-POLYMER LETTERS = J POLYM SCI POL LETT
JOURNAL OF POLYMER SCIENCE-POLYMER SYMPOSIA = J POLYM SCI POL SYM
JOURNAL OF POPULAR CULTURE = J POP CULT
JOURNAL OF POPULAR FILM AND TELEVISION = J POP FILM TV
JOURNAL OF POPULATION ECONOMICS = J POPUL ECON
JOURNAL OF POROUS MATERIALS = J POROUS MAT
JOURNAL OF POROUS MEDIA = J POROUS MEDIA
JOURNAL OF PORPHYRINS AND PHTHALOCYANINES = J PORPHYR PHTHALOCYA
JOURNAL OF PORTFOLIO MANAGEMENT = J PORTFOLIO MANAGE
JOURNAL OF POST KEYNESIAN ECONOMICS = J POST KEYNESIAN EC
JOURNAL OF POWER SOURCES = J POWER SOURCES
JOURNAL OF PRAGMATICS = J PRAGMATICS
JOURNAL OF PRE-RAPHAELITE STUDIES-NEW SERIES = J PRE-RAPHAELITE ST
JOURNAL OF PRESBYTERIAN HISTORY = J PRESBYTERIAN HIST
JOURNAL OF PRESSURE VESSEL TECHNOLOGY-TRANSACTIONS OF THE ASME = J PRESS VESS-T ASME
JOURNAL OF PROCESS CONTROL = J PROCESS CONTR
JOURNAL OF PRODUCT INNOVATION MANAGEMENT = J PROD INNOVAT MANAG
JOURNAL OF PRODUCTION AGRICULTURE = J PROD AGRIC
JOURNAL OF PRODUCTIVITY ANALYSIS = J PROD ANAL
JOURNAL OF PRODUCTS LIABILITY = J PROD LIABILITY
JOURNAL OF PROFESSIONAL ISSUES IN ENGINEERING EDUCATION AND PRACTICE = J PROF ISS ENG ED PR
JOURNAL OF PROFESSIONAL ISSUES IN ENGINEERING-ASCE = J PROF ISS ENG-ASCE
JOURNAL OF PROFESSIONAL NURSING = J PROF NURS
JOURNAL OF PROGRAMMING LANGUAGES = J PROGRAM LANG
JOURNAL OF PROPULSION AND POWER = J PROPUL POWER
JOURNAL OF PROSTHETIC DENTISTRY = J PROSTHET DENT
JOURNAL OF PROSTHETICS AND ORTHOTICS = J PROSTHET ORTHOT
JOURNAL OF PROTEIN CHEMISTRY = J PROTEIN CHEM
JOURNAL OF PROTOZOOLOGY = J PROTOZOOL
JOURNAL OF PROTOZOOLOGY RESEARCH = J PROTOZOOL RES
JOURNAL OF PSYCHIATRIC RESEARCH = J PSYCHIAT RES
JOURNAL OF PSYCHIATRIC TREATMENT AND EVALUATION = J PSYCHIAT TREAT EV
JOURNAL OF PSYCHIATRY & NEUROSCIENCE = J PSYCHIATR NEUROSCI
JOURNAL OF PSYCHOACTIVE DRUGS = J PSYCHOACTIVE DRUGS
JOURNAL OF PSYCHOEDUCATIONAL ASSESSMENT = J PSYCHOEDUC ASSESS
JOURNAL OF PSYCHOHISTORY = J PSYCHOHIST
JOURNAL OF PSYCHOLINGUISTIC RESEARCH = J PSYCHOLINGUIST RES
JOURNAL OF PSYCHOLOGY = J PSYCHOL
JOURNAL OF PSYCHOLOGY AND THEOLOGY = J PSYCHOL THEOL
JOURNAL OF PSYCHOPATHOLOGY AND BEHAVIORAL ASSESSMENT = J PSYCHOPATHOL BEHAV
JOURNAL OF PSYCHOPHARMACOLOGY = J PSYCHOPHARMACOL
JOURNAL OF PSYCHOPHYSIOLOGY = J PSYCHOPHYSIOL
JOURNAL OF PSYCHOSOCIAL ONCOLOGY = J PSYCHOSOC ONCOL
JOURNAL OF PSYCHOSOMATIC OBSTETRICS AND GYNECOLOGY = J PSYCHOSOM OBST GYN
JOURNAL OF PSYCHOSOMATIC RESEARCH = J PSYCHOSOM RES
JOURNAL OF PSYCHOTHERAPY INTEGRATION = J PSYCHOTHER INTEGR
JOURNAL OF PUBLIC ECONOMICS = J PUBLIC ECON
JOURNAL OF PUBLIC HEALTH DENTISTRY = J PUBLIC HEALTH DENT
JOURNAL OF PUBLIC HEALTH MEDICINE = J PUBLIC HEALTH MED
JOURNAL OF PUBLIC HEALTH POLICY = J PUBLIC HEALTH POL
JOURNAL OF PUBLIC POLICY & MARKETING = J PUBLIC POLICY MARK
JOURNAL OF PULP AND PAPER SCIENCE = J PULP PAP SCI
JOURNAL OF PURE AND APPLIED ALGEBRA = J PURE APPL ALGEBRA
JOURNAL OF QUALITY TECHNOLOGY = J QUAL TECHNOL
JOURNAL OF QUANTITATIVE CRIMINOLOGY = J QUANT CRIMINOL
JOURNAL OF QUANTITATIVE SPECTROSCOPY & RADIATIVE TRANSFER = J QUANT SPECTROSC RA
JOURNAL OF QUATERNARY SCIENCE = J QUATERNARY SCI
JOURNAL OF RADIATION RESEARCH = J RADIAT RES
JOURNAL OF RADIOANALYTICAL AND NUCLEAR CHEMISTRY = J RADIOANAL NUCL CH
JOURNAL OF RADIOANALYTICAL AND NUCLEAR CHEMISTRY-ARTICLES = J RADIOAN NUCL CH AR
JOURNAL OF RADIOANALYTICAL AND NUCLEAR CHEMISTRY-LETTERS = J RADIOAN NUCL CH LE
JOURNAL OF RADIOANALYTICAL CHEMISTRY = J RADIOANAL CHEM
JOURNAL OF RAMAN SPECTROSCOPY = J RAMAN SPECTROSC
JOURNAL OF RANGE MANAGEMENT = J RANGE MANAGE
JOURNAL OF RAPID METHODS AND AUTOMATION IN MICROBIOLOGY = J RAPID METH AUT MIC
JOURNAL OF RAPTOR RESEARCH = J RAPTOR RES
JOURNAL OF RARE EARTHS = J RARE EARTH
JOURNAL OF READING = J READING
JOURNAL OF READING BEHAVIOR = J READING BEHAV
JOURNAL OF REAL ESTATE FINANCE AND ECONOMICS = J REAL ESTATE FINANC
JOURNAL OF REAL ESTATE TAXATION = J REAL ESTATE TAX
JOURNAL OF RECEPTOR AND SIGNAL TRANSDUCTION RESEARCH = J RECEPT SIGNAL TR R
JOURNAL OF RECEPTOR RESEARCH = J RECEPTOR RES
JOURNAL OF RECONSTRUCTIVE MICROSURGERY = J RECONSTR MICROSURG
JOURNAL OF REFRACTIVE AND CORNEAL SURGERY = J REFRACT CORNEAL S
JOURNAL OF REFRACTIVE SURGERY = J REFRACT SURG
JOURNAL OF REGIONAL SCIENCE = J REGIONAL SCI
JOURNAL OF REGULATORY ECONOMICS = J REGUL ECON
JOURNAL OF REHABILITATION = J REHABIL
JOURNAL OF REHABILITATION RESEARCH AND DEVELOPMENT = J REHABIL RES DEV
JOURNAL OF REINFORCED PLASTICS AND COMPOSITES = J REINF PLAST COMP
JOURNAL OF RELIGION = J RELIG
JOURNAL OF RELIGION & HEALTH = J RELIG HEALTH
JOURNAL OF RELIGIOUS ETHICS = J RELIG ETHICS
JOURNAL OF RELIGIOUS HISTORY = J RELIG HIST
JOURNAL OF REPRODUCTION AND FERTILITY = J REPROD FERTIL
JOURNAL OF REPRODUCTIVE AND INFANT PSYCHOLOGY = J REPROD INFANT PSYC
JOURNAL OF REPRODUCTIVE IMMUNOLOGY = J REPROD IMMUNOL
JOURNAL OF REPRODUCTIVE MEDICINE = J REPROD MED
JOURNAL OF RESEARCH AND PRACTICE IN INFORMATION TECHNOLOGY = J RES PRACT INF TECH
JOURNAL OF RESEARCH IN CRIME AND DELINQUENCY = J RES CRIME DELINQ
JOURNAL OF RESEARCH IN MUSIC EDUCATION = J RES MUSIC EDUC
JOURNAL OF RESEARCH IN PERSONALITY = J RES PERS
JOURNAL OF RESEARCH IN SCIENCE TEACHING = J RES SCI TEACH
JOURNAL OF RESEARCH OF THE NATIONAL BUREAU OF STANDARDS = J RES NAT BUR STAND
JOURNAL OF RESEARCH OF THE NATIONAL BUREAU OF STANDARDS = J RES NATL INST STAN
JOURNAL OF RESEARCH OF THE NATIONAL INSTITUTE OF STANDARDS AND TECHNOLOGY = J RES NATL INST STAN
JOURNAL OF RESEARCH ON ADOLESCENCE = J RES ADOLESCENCE
JOURNAL OF RETAILING = J RETAILING
JOURNAL OF RHEOLOGY = J RHEOL
JOURNAL OF RHEUMATOLOGY = J RHEUMATOL
JOURNAL OF RISK AND INSURANCE = J RISK INSUR
JOURNAL OF RISK AND UNCERTAINTY = J RISK UNCERTAINTY
JOURNAL OF ROBOTIC SYSTEMS = J ROBOTIC SYST
JOURNAL OF ROMAN STUDIES = J ROMAN STUD
JOURNAL OF RURAL DEVELOPMENT = J RURAL DEVELOP
JOURNAL OF RURAL HEALTH = J RURAL HEALTH
JOURNAL OF RURAL STUDIES = J RURAL STUD
JOURNAL OF RUSSIAN LASER RESEARCH = J RUSS LASER RES
JOURNAL OF SAFETY RESEARCH = J SAFETY RES
JOURNAL OF SCHOLARLY PUBLISHING = J SCHOLARLY PUBL
JOURNAL OF SCHOOL HEALTH = J SCHOOL HEALTH
JOURNAL OF SCHOOL PSYCHOLOGY = J SCHOOL PSYCHOL
JOURNAL OF SCIENTIFIC & INDUSTRIAL RESEARCH = J SCI IND RES INDIA
JOURNAL OF SEA RESEARCH = J SEA RES
JOURNAL OF SEDIMENTARY PETROLOGY = J SEDIMENT PETROL
JOURNAL OF SEDIMENTARY RESEARCH = J SEDIMENT RES
JOURNAL OF SEDIMENTARY RESEARCH SECTION A-SEDIMENTARY PETROLOGY AND PROCESSES = J SEDIMENT RES A
JOURNAL OF SEDIMENTARY RESEARCH SECTION B-STRATIGRAPHY AND GLOBAL STUDIES = J SEDIMENT RES B
JOURNAL OF SEED TECHNOLOGY = J SEED TECHNOL
JOURNAL OF SEISMIC EXPLORATION = J SEISM EXPLOR
JOURNAL OF SEISMOLOGY = J SEISMOL
JOURNAL OF SEMITIC STUDIES = J SEMITIC STUD
JOURNAL OF SENSORY STUDIES = J SENS STUD
JOURNAL OF SEX & MARITAL THERAPY = J SEX MARITAL THER
JOURNAL OF SEX EDUCATION & THERAPY = J SEX EDUC THER
JOURNAL OF SEX RESEARCH = J SEX RES
JOURNAL OF SHELLFISH RESEARCH = J SHELLFISH RES
JOURNAL OF SHIP RESEARCH = J SHIP RES
JOURNAL OF SHOULDER AND ELBOW SURGERY = J SHOULDER ELB SURG
JOURNAL OF SLEEP RESEARCH = J SLEEP RES
JOURNAL OF SMALL ANIMAL PRACTICE = J SMALL ANIM PRACT
JOURNAL OF SMALL BUSINESS MANAGEMENT = J SMALL BUS MANAGE
JOURNAL OF SOCIAL AND CLINICAL PSYCHOLOGY = J SOC CLIN PSYCHOL
JOURNAL OF SOCIAL AND EVOLUTIONARY SYSTEMS = J SOC EVOL SYST
JOURNAL OF SOCIAL AND PERSONAL RELATIONSHIPS = J SOC PERS RELAT
JOURNAL OF SOCIAL BEHAVIOR AND PERSONALITY = J SOC BEHAV PERS
JOURNAL OF SOCIAL DISTRESS AND THE HOMELESS = J SOC DISTRESS HOMEL
JOURNAL OF SOCIAL HISTORY = J SOC HIST
JOURNAL OF SOCIAL ISSUES = J SOC ISSUES
JOURNAL OF SOCIAL POLICY = J SOC POLICY
JOURNAL OF SOCIAL POLITICAL AND ECONOMIC STUDIES = J SOC POLIT ECON ST
JOURNAL OF SOCIAL PSYCHOLOGY = J SOC PSYCHOL
JOURNAL OF SOCIAL SERVICE RESEARCH = J SOC SERV RES
JOURNAL OF SOCIAL WORK EDUCATION = J SOC WORK EDUC
JOURNAL OF SOCIAL WORK PRACTICE = J SOC WORK PRACT
JOURNAL OF SOCIOLOGY = J SOCIOL
JOURNAL OF SOCIOLOGY AND SOCIAL WELFARE = J SOCIOL SOC WELFARE
JOURNAL OF SOFTWARE MAINTENANCE-RESEARCH AND PRACTICE = J SOFTW MAINT-RES PR
JOURNAL OF SOIL AND WATER CONSERVATION = J SOIL WATER CONSERV
JOURNAL OF SOIL CONTAMINATION = J SOIL CONTAM
JOURNAL OF SOIL SCIENCE = J SOIL SCI
JOURNAL OF SOL-GEL SCIENCE AND TECHNOLOGY = J SOL-GEL SCI TECHN
JOURNAL OF SOLAR ENERGY ENGINEERING-TRANSACTIONS OF THE ASME = J SOL ENERG-T ASME
JOURNAL OF SOLID STATE CHEMISTRY = J SOLID STATE CHEM
JOURNAL OF SOLID STATE ELECTROCHEMISTRY = J SOLID STATE ELECTR
JOURNAL OF SOLUTION CHEMISTRY = J SOLUTION CHEM
JOURNAL OF SOUND AND VIBRATION = J SOUND VIB
JOURNAL OF SOUTH AMERICAN EARTH SCIENCES = J S AM EARTH SCI
JOURNAL OF SOUTHEAST ASIAN EARTH SCIENCES = J SOUTHE ASIAN EARTH
JOURNAL OF SOUTHEAST ASIAN STUDIES = J SOUTHE ASIAN STUD
JOURNAL OF SOUTHERN AFRICAN STUDIES = J S AFR STUD
JOURNAL OF SOUTHERN HISTORY = J SOUTHERN HIST
JOURNAL OF SPACECRAFT AND ROCKETS = J SPACECRAFT ROCKETS
JOURNAL OF SPECIAL EDUCATION = J SPEC EDUC
JOURNAL OF SPEECH AND HEARING DISORDERS = J SPEECH HEAR DISORD
JOURNAL OF SPEECH AND HEARING RESEARCH = J SPEECH HEAR RES
JOURNAL OF SPEECH LANGUAGE AND HEARING RESEARCH = J SPEECH LANG HEAR R
JOURNAL OF SPINAL DISORDERS = J SPINAL DISORD
JOURNAL OF SPORT & EXERCISE PSYCHOLOGY = J SPORT EXERCISE PSY
JOURNAL OF SPORT HISTORY = J SPORT HIST
JOURNAL OF SPORT MANAGEMENT = J SPORT MANAGE
JOURNAL OF SPORT REHABILITATION = J SPORT REHABIL
JOURNAL OF SPORTS CHIROPRACTIC & REHABILITATION = J SPORT CHIROPR REH
JOURNAL OF SPORTS MEDICINE AND PHYSICAL FITNESS = J SPORT MED PHYS FIT
JOURNAL OF SPORTS SCIENCES = J SPORT SCI
JOURNAL OF SPORTS TRAUMATOLOGY AND RELATED RESEARCH = J SPORT TRAUMATOL
JOURNAL OF STATISTICAL COMPUTATION AND SIMULATION = J STAT COMPUT SIM
JOURNAL OF STATISTICAL PHYSICS = J STAT PHYS
JOURNAL OF STATISTICAL PLANNING AND INFERENCE = J STAT PLAN INFER
JOURNAL OF STEROID BIOCHEMISTRY AND MOLECULAR BIOLOGY = J STEROID BIOCHEM
JOURNAL OF STONE DISEASE = J STONE DIS
JOURNAL OF STORED PRODUCTS RESEARCH = J STORED PROD RES
JOURNAL OF STRAIN ANALYSIS FOR ENGINEERING DESIGN = J STRAIN ANAL ENG
JOURNAL OF STRATEGIC INFORMATION SYSTEMS = J STRATEGIC INF SYST
JOURNAL OF STRATEGIC STUDIES = J STRATEGIC STUD
JOURNAL OF STRENGTH AND CONDITIONING RESEARCH = J STRENGTH COND RES
JOURNAL OF STRUCTURAL BIOLOGY = J STRUCT BIOL
JOURNAL OF STRUCTURAL CHEMISTRY = J STRUCT CHEM+
JOURNAL OF STRUCTURAL ENGINEERING-ASCE = J STRUCT ENG-ASCE
JOURNAL OF STRUCTURAL GEOLOGY = J STRUCT GEOL
JOURNAL OF STRUCTURAL MECHANICS = J STRUCT MECH
JOURNAL OF STUDIES ON ALCOHOL = J STUD ALCOHOL
JOURNAL OF SUBMICROSCOPIC CYTOLOGY AND PATHOLOGY = J SUBMICR CYTOL PATH
JOURNAL OF SUBSTANCE ABUSE = J SUBST ABUSE
JOURNAL OF SUBSTANCE ABUSE TREATMENT = J SUBST ABUSE TREAT
JOURNAL OF SUPERCOMPUTING = J SUPERCOMPUT
JOURNAL OF SUPERCONDUCTIVITY = J SUPERCOND
JOURNAL OF SUPERCRITICAL FLUIDS = J SUPERCRIT FLUID
JOURNAL OF SUPRAMOLECULAR STRUCTURE AND CELLULAR BIOCHEMISTRY = J SUPRAMOL STR CELL
JOURNAL OF SURFACTANTS AND DETERGENTS = J SURFACTANTS DETERG
JOURNAL OF SURGICAL ONCOLOGY = J SURG ONCOL
JOURNAL OF SURGICAL RESEARCH = J SURG RES
JOURNAL OF SURVEYING ENGINEERING-ASCE = J SURV ENG-ASCE
JOURNAL OF SUSTAINABLE AGRICULTURE = J SUSTAIN AGR
JOURNAL OF SYMBOLIC COMPUTATION = J SYMB COMPUT
JOURNAL OF SYMBOLIC LOGIC = J SYMBOLIC LOGIC
JOURNAL OF SYNCHROTRON RADIATION = J SYNCHROTRON RADIAT
JOURNAL OF SYNTHETIC ORGANIC CHEMISTRY JAPAN = J SYN ORG CHEM JPN
JOURNAL OF SYSTEMS AND SOFTWARE = J SYST SOFTWARE
JOURNAL OF SYSTEMS ARCHITECTURE = J SYST ARCHITECT
JOURNAL OF SYSTEMS ENGINEERING = J SYST ENG
JOURNAL OF SYSTEMS MANAGEMENT = J SYST MANAGE
JOURNAL OF TAXATION = J TAX
JOURNAL OF TEACHER EDUCATION = J TEACH EDUC
JOURNAL OF TEACHING IN PHYSICAL EDUCATION = J TEACH PHYS EDUC
JOURNAL OF TECHNICAL TOPICS IN CIVIL ENGINEERING-ASCE = J TECH TOP CIV-ASCE
JOURNAL OF TECHNICAL WRITING AND COMMUNICATION = J TECH WRIT COMMUN
JOURNAL OF TECHNOLOGY TRANSFER = J TECHNOL TRANSFER
JOURNAL OF TELECOMMUNICATION NETWORKS = J TELECOMMUN NETWORK
JOURNAL OF TELEMEDICINE AND TELECARE = J TELEMED TELECARE
JOURNAL OF TERRAMECHANICS = J TERRAMECHANICS
JOURNAL OF TESTING AND EVALUATION = J TEST EVAL
JOURNAL OF TEXTURE STUDIES = J TEXTURE STUD
JOURNAL OF THE ACADEMY OF MARKETING SCIENCE = J ACAD MARKET SCI
JOURNAL OF THE ACM = J ACM
JOURNAL OF THE ACOUSTICAL SOCIETY OF AMERICA = J ACOUST SOC AM
JOURNAL OF THE AGRICULTURAL ASSOCIATION OF CHINA = J AGR ASSOC CHINA
JOURNAL OF THE AGRICULTURAL CHEMICAL SOCIETY OF JAPAN = J AGR CHEM SOC JPN
JOURNAL OF THE AGRICULTURAL CHEMICAL SOCIETY OF JAPAN = NIPPON NOGEIK KAISHI
JOURNAL OF THE AGRICULTURAL SOCIETY OF TRINIDAD & TOBAGO = J AGR SOC TRINID TOB
JOURNAL OF THE AIR & WASTE MANAGEMENT ASSOCIATION = J AIR WASTE MANAGE
JOURNAL OF THE AIR POLLUTION CONTROL ASSOCIATION = JAPCA J AIR WASTE MA
JOURNAL OF THE AMERICAN ACADEMY OF CHILD AND ADOLESCENT PSYCHIATRY = J AM ACAD CHILD PSY
JOURNAL OF THE AMERICAN ACADEMY OF DERMATOLOGY = J AM ACAD DERMATOL
JOURNAL OF THE AMERICAN ACADEMY OF PSYCHIATRY AND THE LAW = J AM ACAD PSYCHIATRY
JOURNAL OF THE AMERICAN ACADEMY OF RELIGION = J AM ACAD RELIG
JOURNAL OF THE AMERICAN ANIMAL HOSPITAL ASSOCIATION = J AM ANIM HOSP ASSOC
JOURNAL OF THE AMERICAN ASSOCIATION OF GYNECOLOGIC LAPAROSCOPISTS = J AM ASSOC GYN LAP
JOURNAL OF THE AMERICAN CERAMIC SOCIETY = J AM CERAM SOC
JOURNAL OF THE AMERICAN CHEMICAL SOCIETY = J AM CHEM SOC
JOURNAL OF THE AMERICAN COLLEGE OF CARDIOLOGY = J AM COLL CARDIOL
JOURNAL OF THE AMERICAN COLLEGE OF NUTRITION = J AM COLL NUTR
JOURNAL OF THE AMERICAN COLLEGE OF SURGEONS = J AM COLL SURGEONS
JOURNAL OF THE AMERICAN COLLEGE OF TOXICOLOGY = J AM COLL TOXICOL
JOURNAL OF THE AMERICAN CONCRETE INSTITUTE = J AM CONCRETE I
JOURNAL OF THE AMERICAN DENTAL ASSOCIATION = J AM DENT ASSOC
JOURNAL OF THE AMERICAN DIETETIC ASSOCIATION = J AM DIET ASSOC
JOURNAL OF THE AMERICAN GERIATRICS SOCIETY = J AM GERIATR SOC
JOURNAL OF THE AMERICAN HELICOPTER SOCIETY = J AM HELICOPTER SOC
JOURNAL OF THE AMERICAN INSTITUTE FOR CONSERVATION = J AM INST CONSERV
JOURNAL OF THE AMERICAN LEATHER CHEMISTS ASSOCIATION = J AM LEATHER CHEM AS
JOURNAL OF THE AMERICAN MATHEMATICAL SOCIETY = J AM MATH SOC
JOURNAL OF THE AMERICAN MEDICAL INFORMATICS ASSOCIATION = J AM MED INFORM ASSN
JOURNAL OF THE AMERICAN MEDICAL TECHNOLOGISTS = J AM MED TECHNOL
JOURNAL OF THE AMERICAN MOSQUITO CONTROL ASSOCIATION = J AM MOSQUITO CONTR
JOURNAL OF THE AMERICAN MUSICAL INSTRUMENT SOCIETY = J AM MUSIC INSTRUM S
JOURNAL OF THE AMERICAN MUSICOLOGICAL SOCIETY = J AM MUSIC SOC
JOURNAL OF THE AMERICAN OIL CHEMISTS SOCIETY = J AM OIL CHEM SOC
JOURNAL OF THE AMERICAN OPTOMETRIC ASSOCIATION = J AM OPTOM ASSOC
JOURNAL OF THE AMERICAN ORIENTAL SOCIETY = J AM ORIENTAL SOC
JOURNAL OF THE AMERICAN OSTEOPATHIC ASSOCIATION = J AM OSTEOPATH ASSOC
JOURNAL OF THE AMERICAN PLANNING ASSOCIATION = J AM PLANN ASSOC
JOURNAL OF THE AMERICAN PODIATRIC MEDICAL ASSOCIATION = J AM PODIAT MED ASSN
JOURNAL OF THE AMERICAN PODIATRY ASSOCIATION = J AM POD ASSOC
JOURNAL OF THE AMERICAN PSYCHOANALYTIC ASSOCIATION = J AM PSYCHOANAL ASS
JOURNAL OF THE AMERICAN REAL ESTATE AND URBAN ECONOMICS ASSOCIATION = J AM REAL ESTATE URB
JOURNAL OF THE AMERICAN SOCIETY FOR HORTICULTURAL SCIENCE = J AM SOC HORTIC SCI
JOURNAL OF THE AMERICAN SOCIETY FOR INFORMATION SCIENCE = J AM SOC INFORM SCI
JOURNAL OF THE AMERICAN SOCIETY FOR MASS SPECTROMETRY = J AM SOC MASS SPECTR
JOURNAL OF THE AMERICAN SOCIETY FOR PSYCHICAL RESEARCH = J AM SOC PSYCHICAL R
JOURNAL OF THE AMERICAN SOCIETY OF BREWING CHEMISTS = J AM SOC BREW CHEM
JOURNAL OF THE AMERICAN SOCIETY OF ECHOCARDIOGRAPHY = J AM SOC ECHOCARDIOG
JOURNAL OF THE AMERICAN SOCIETY OF NEPHROLOGY = J AM SOC NEPHROL
JOURNAL OF THE AMERICAN STATISTICAL ASSOCIATION = J AM STAT ASSOC
JOURNAL OF THE AMERICAN VETERINARY MEDICAL ASSOCIATION = J AM VET MED ASSOC
JOURNAL OF THE AMERICAN WATER RESOURCES ASSOCIATION = J AM WATER RESOUR AS
JOURNAL OF THE ARNOLD ARBORETUM = J ARNOLD ARBORETUM
JOURNAL OF THE ARNOLD SCHOENBERG INSTITUTE = J ARNOLD SCHOENBERG
JOURNAL OF THE ASSOCIATION FOR COMPUTING MACHINERY = J ASSOC COMPUT MACH
JOURNAL OF THE ASSOCIATION FOR PERSONS WITH SEVERE HANDICAPS = J ASSOC PERS SEVERE
JOURNAL OF THE ASSOCIATION OF OFFICIAL ANALYTICAL CHEMISTS = J ASSOC OFF ANA CHEM
JOURNAL OF THE ASSOCIATION OF PUBLIC ANALYSTS = J ASSOC PUBLIC ANAL
JOURNAL OF THE ASTRONAUTICAL SCIENCES = J ASTRONAUT SCI
JOURNAL OF THE ATMOSPHERIC SCIENCES = J ATMOS SCI
JOURNAL OF THE ATOMIC ENERGY SOCIETY OF JAPAN = J ATOM ENERG SOC JPN
JOURNAL OF THE AUDIO ENGINEERING SOCIETY = J AUDIO ENG SOC
JOURNAL OF THE AUSTRALASIAN CERAMIC SOCIETY = J AUST CERAM SOC
JOURNAL OF THE AUSTRALIAN ENTOMOLOGICAL SOCIETY = J AUST ENTOMOL SOC
JOURNAL OF THE AUSTRALIAN INSTITUTE OF AGRICULTURAL SCIENCE = J AUST I AGR SCI
JOURNAL OF THE AUSTRALIAN MATHEMATICAL SOCIETY SERIES A-PURE MATHEMATICS AND STATISTICS = J AUST MATH SOC A
JOURNAL OF THE AUSTRALIAN MATHEMATICAL SOCIETY SERIES B-APPLIED MATHEMATICS = J AUST MATH SOC B
JOURNAL OF THE AUTONOMIC NERVOUS SYSTEM = J AUTONOM NERV SYST
JOURNAL OF THE BRAZILIAN CHEMICAL SOCIETY = J BRAZIL CHEM SOC
JOURNAL OF THE BRITISH ASSOCIATION OF TEACHERS OF THE DEAF = TEACH DEAF
JOURNAL OF THE BRITISH SOCIETY FOR PHENOMENOLOGY = J BRIT SOC PHENOMEN
JOURNAL OF THE CANADIAN ASSOCIATION OF RADIOLOGISTS-JOURNAL DE L ASSOCIATION CANADIENNE DES RADIOLOGISTES = J CAN ASSOC RADIOL
JOURNAL OF THE CANADIAN CERAMIC SOCIETY = J CAN CERAM SOC
JOURNAL OF THE CANADIAN DIETETIC ASSOCIATION-REVUE DE L ASSOCIATION CANADIENNE DES DIETETISTES = J CAN DIET ASSOC
JOURNAL OF THE CANADIAN HISTORICAL ASSOCIATION-REVUE DE LA SOCIETE HISTORIQUE DU CANADA = J CAN HIST ASSOC
JOURNAL OF THE CERAMIC SOCIETY OF JAPAN = J CERAM SOC JPN
JOURNAL OF THE CHARTERED INSTITUTION OF WATER AND ENVIRONMENTAL MANAGEMENT = J CHART INST WATER E
JOURNAL OF THE CHEMICAL SOCIETY OF PAKISTAN = J CHEM SOC PAKISTAN
JOURNAL OF THE CHEMICAL SOCIETY-CHEMICAL COMMUNICATIONS = J CHEM SOC CHEM COMM
JOURNAL OF THE CHEMICAL SOCIETY-DALTON TRANSACTIONS = J CHEM SOC DALTON
JOURNAL OF THE CHEMICAL SOCIETY-FARADAY TRANSACTIONS = J CHEM SOC FARADAY T
JOURNAL OF THE CHEMICAL SOCIETY-FARADAY TRANSACTIONS I = J CHEM SOC FARAD T 1
JOURNAL OF THE CHEMICAL SOCIETY-FARADAY TRANSACTIONS II = J CHEM SOC FARAD T 2
JOURNAL OF THE CHEMICAL SOCIETY-PERKIN TRANSACTIONS 1 = J CHEM SOC PERK T 1
JOURNAL OF THE CHEMICAL SOCIETY-PERKIN TRANSACTIONS 2 = J CHEM SOC PERK T 2
JOURNAL OF THE CHINESE CHEMICAL SOCIETY = J CHIN CHEM SOC-TAIP
JOURNAL OF THE CHINESE INSTITUTE OF CHEMICAL ENGINEERS = J CHIN INST CHEM ENG
JOURNAL OF THE CHINESE INSTITUTE OF ENGINEERS = J CHIN INST ENG
JOURNAL OF THE COMMUNICATIONS RESEARCH LABORATORY = J COMMUN RES LAB
JOURNAL OF THE CONSTRUCTION DIVISION-ASCE = J CONSTRUCT DIV-ASCE
JOURNAL OF THE COPYRIGHT SOCIETY OF THE USA = J COPYRIGHT SOC USA
JOURNAL OF THE EARLY REPUBLIC = J EARLY REPUBL
JOURNAL OF THE ELECTROCHEMICAL SOCIETY = J ELECTROCHEM SOC
JOURNAL OF THE ELISHA MITCHELL SCIENTIFIC SOCIETY = J ELISHA MITCH SCI S
JOURNAL OF THE ENERGY DIVISION-ASCE = J ENERG DIV-ASCE
JOURNAL OF THE ENGINEERING MECHANICS DIVISION-ASCE = J ENG MECH DIV-ASCE
JOURNAL OF THE ENTOMOLOGICAL SOCIETY OF SOUTHERN AFRICA = J ENTOMOL SOC S AFR
JOURNAL OF THE ENVIRONMENTAL ENGINEERING DIVISION-ASCE = J ENV ENG DIV-ASCE
JOURNAL OF THE EUROPEAN ACADEMY OF DERMATOLOGY AND VENEREOLOGY = J EUR ACAD DERMATOL
JOURNAL OF THE EUROPEAN CERAMIC SOCIETY = J EUR CERAM SOC
JOURNAL OF THE EXPERIMENTAL ANALYSIS OF BEHAVIOR = J EXP ANAL BEHAV
JOURNAL OF THE FACULTY OF AGRICULTURE KYUSHU UNIVERSITY = J FAC AGR KYUSHU U
JOURNAL OF THE FLORIDA MEDICAL ASSOCIATION = J FLA MED ASSOC
JOURNAL OF THE FOOD HYGIENIC SOCIETY OF JAPAN = J FOOD HYG SOC JPN
JOURNAL OF THE FORENSIC SCIENCE SOCIETY = J FORENSIC SCI SOC
JOURNAL OF THE FORMOSAN MEDICAL ASSOCIATION = J FORMOS MED ASSOC
JOURNAL OF THE FRANKLIN INSTITUTE-ENGINEERING AND APPLIED MATHEMATICS = J FRANKLIN I
JOURNAL OF THE GEOLOGICAL SOCIETY = J GEOL SOC LONDON
JOURNAL OF THE GEOLOGICAL SOCIETY OF AUSTRALIA = J GEOL SOC AUST
JOURNAL OF THE GEOLOGICAL SOCIETY OF INDIA = J GEOL SOC INDIA
JOURNAL OF THE GEORGIA ENTOMOLOGICAL SOCIETY = J GEORGIA ENTOMOL SO
JOURNAL OF THE GEOTECHNICAL ENGINEERING DIVISION-ASCE = J GEOTECH ENG-ASCE
JOURNAL OF THE HELMINTHOLOGICAL SOCIETY OF WASHINGTON = J HELMINTHOL SOC W
JOURNAL OF THE HISTORY OF BIOLOGY = J HIST BIOL
JOURNAL OF THE HISTORY OF IDEAS = J HIST IDEAS
JOURNAL OF THE HISTORY OF MEDICINE AND ALLIED SCIENCES = J HIST MED ALL SCI
JOURNAL OF THE HISTORY OF PHILOSOPHY = J HIST PHILOS
JOURNAL OF THE HISTORY OF SEXUALITY = J HIST SEXUALITY
JOURNAL OF THE HISTORY OF THE BEHAVIORAL SCIENCES = J HIST BEHAV SCI
JOURNAL OF THE HYDRAULICS DIVISION-ASCE = J HYDR ENG DIV-ASCE
JOURNAL OF THE IES = J IES
JOURNAL OF THE IEST = J IEST
JOURNAL OF THE ILLUMINATING ENGINEERING SOCIETY = J ILLUM ENG SOC
JOURNAL OF THE INDIAN CHEMICAL SOCIETY = J INDIAN CHEM SOC
JOURNAL OF THE INDIAN INSTITUTE OF SCIENCE SECTION A-ENGINEERING & TECHNOLOGY = J INDIAN I SCI A-ENG
JOURNAL OF THE INDIAN INSTITUTE OF SCIENCE SECTION B-PHYSICAL & CHEMICAL SCIENCES = J INDIAN I SCI B-PHY
JOURNAL OF THE INDIAN INSTITUTE OF SCIENCE SECTION C-BIOLOGICAL SCIENCES = J INDIAN I SCI C-BIO
JOURNAL OF THE INSTITUTE OF BREWING = J I BREWING
JOURNAL OF THE INSTITUTE OF ENERGY = J I ENERGY
JOURNAL OF THE INSTITUTE OF ENVIRONMENTAL SCIENCES = J INST ENVIRON SCI
JOURNAL OF THE INSTITUTE OF WOOD SCIENCE = J I WOOD SCI
JOURNAL OF THE INSTITUTION OF ELECTRONIC AND RADIO ENGINEERS = J I ELECTRON RAD ENG
JOURNAL OF THE INSTITUTION OF ELECTRONICS AND TELECOMMUNICATION ENGINEERS = J I EL TELECOM ENG
JOURNAL OF THE INSTITUTION OF WATER AND ENVIRONMENTAL MANAGEMENT = J INST WATER ENV MAN
JOURNAL OF THE INTERNATIONAL ASSOCIATION FOR MATHEMATICAL GEOLOGY = J INT ASS MATH GEOL
JOURNAL OF THE INTERNATIONAL NEUROPSYCHOLOGICAL SOCIETY = J INT NEUROPSYCH SOC
JOURNAL OF THE IRISH COLLEGES OF PHYSICIANS AND SURGEONS = J IRISH COLL PHYS S
JOURNAL OF THE IRRIGATION AND DRAINAGE DIVISION-ASCE = J IRR DRAIN DIV-ASCE
JOURNAL OF THE JAPAN INSTITUTE OF METALS = J JPN I MET
JOURNAL OF THE JAPANESE AND INTERNATIONAL ECONOMIES = J JPN INT ECON
JOURNAL OF THE JAPANESE SOCIETY FOR FOOD SCIENCE AND TECHNOLOGY-NIPPON SHOKUHIN KAGAKU KOGAKU KAISHI = J JPN SOC FOOD SCI
JOURNAL OF THE JAPANESE SOCIETY FOR HORTICULTURAL SCIENCE = J JPN SOC HORTIC SCI
JOURNAL OF THE KANSAS ENTOMOLOGICAL SOCIETY = J KANSAS ENTOMOL SOC
JOURNAL OF THE KENTUCKY MEDICAL ASSOCIATION = J KENTUCKY MED ASSOC
JOURNAL OF THE KOREAN PHYSICAL SOCIETY = J KOREAN PHYS SOC
JOURNAL OF THE KUWAIT MEDICAL ASSOCIATION = J KUWAIT MED ASSOC
JOURNAL OF THE LEARNING SCIENCES = J LEARN SCI
JOURNAL OF THE LESS-COMMON METALS = J LESS-COMMON MET
JOURNAL OF THE LIMNOLOGICAL SOCIETY OF SOUTHERN AFRICA = J LIMNOL SOC S AFR
JOURNAL OF THE LONDON MATHEMATICAL SOCIETY-SECOND SERIES = J LOND MATH SOC
JOURNAL OF THE MARINE BIOLOGICAL ASSOCIATION OF THE UNITED KINGDOM = J MAR BIOL ASSOC UK
JOURNAL OF THE MARKET RESEARCH SOCIETY = J MARKET RES SOC
JOURNAL OF THE MATHEMATICAL SOCIETY OF JAPAN = J MATH SOC JPN
JOURNAL OF THE MECHANICS AND PHYSICS OF SOLIDS = J MECH PHYS SOLIDS
JOURNAL OF THE MEDICAL ASSOCIATION OF THAILAND = J MED ASSOC THAILAND
JOURNAL OF THE METEOROLOGICAL SOCIETY OF JAPAN = J METEOROL SOC JPN
JOURNAL OF THE MIDWEST MODERN LANGUAGE ASSOCIATION = J MIDWEST MOD LANG
JOURNAL OF THE NATIONAL CANCER INSTITUTE = J NATL CANCER I
JOURNAL OF THE NATIONAL MEDICAL ASSOCIATION = J NATL MED ASSOC
JOURNAL OF THE NEUROLOGICAL SCIENCES = J NEUROL SCI
JOURNAL OF THE NEW YORK ENTOMOLOGICAL SOCIETY = J NEW YORK ENTOMOL S
JOURNAL OF THE NORTH AMERICAN BENTHOLOGICAL SOCIETY = J N AM BENTHOL SOC
JOURNAL OF THE OIL & COLOUR CHEMISTS ASSOCIATION = J OIL COLOUR CHEM AS
JOURNAL OF THE OPERATIONAL RESEARCH SOCIETY = J OPER RES SOC
JOURNAL OF THE OPERATIONS RESEARCH SOCIETY OF JAPAN = J OPER RES SOC JPN
JOURNAL OF THE OPTICAL SOCIETY OF AMERICA = J OPT SOC AM
JOURNAL OF THE OPTICAL SOCIETY OF AMERICA A-OPTICS IMAGE SCIENCE AND VISION = J OPT SOC AM A
JOURNAL OF THE OPTICAL SOCIETY OF AMERICA B-OPTICAL PHYSICS = J OPT SOC AM B
JOURNAL OF THE PERIPHERAL NERVOUS SYSTEM = J PERIPHER NERV SYST
JOURNAL OF THE PHILOSOPHY OF SPORT = J PHILOS SPORT
JOURNAL OF THE PHYSICAL SOCIETY OF JAPAN = J PHYS SOC JPN
JOURNAL OF THE POLYNESIAN SOCIETY = J POLYNESIAN SOC
JOURNAL OF THE PROFESSIONAL ASSOCIATION FOR CACTUS DEVELOPMENT = J PROF ASSOC CACTUS
JOURNAL OF THE RADIO RESEARCH LABORATORY = J RADIO RES LAB
JOURNAL OF THE RETICULOENDOTHELIAL SOCIETY = J RETICULOENDOTH SOC
JOURNAL OF THE ROYAL ANTHROPOLOGICAL INSTITUTE = J ROY ANTHROPOL INST
JOURNAL OF THE ROYAL ASIATIC SOCIETY = J ROY ASIATIC SOC
JOURNAL OF THE ROYAL ASTRONOMICAL SOCIETY OF CANADA = J ROY ASTRON SOC CAN
JOURNAL OF THE ROYAL COLLEGE OF GENERAL PRACTITIONERS = J ROY COLL GEN PRACT
JOURNAL OF THE ROYAL COLLEGE OF PHYSICIANS OF LONDON = J ROY COLL PHYS LOND
JOURNAL OF THE ROYAL COLLEGE OF SURGEONS OF EDINBURGH = J ROY COLL SURG EDIN
JOURNAL OF THE ROYAL MUSICAL ASSOCIATION = J ROY MUSIC ASSN
JOURNAL OF THE ROYAL SOCIETY FOR THE PROMOTION OF HEALTH = J R SOC PROMO HEALTH
JOURNAL OF THE ROYAL SOCIETY OF HEALTH = J ROY SOC HEALTH
JOURNAL OF THE ROYAL SOCIETY OF MEDICINE = J ROY SOC MED
JOURNAL OF THE ROYAL SOCIETY OF NEW ZEALAND = J ROY SOC NEW ZEAL
JOURNAL OF THE ROYAL STATISTICAL SOCIETY SERIES A-STATISTICS IN SOCIETY = J ROY STAT SOC A STA
JOURNAL OF THE ROYAL STATISTICAL SOCIETY SERIES B-METHODOLOGICAL = J ROY STAT SOC B MET
JOURNAL OF THE ROYAL STATISTICAL SOCIETY SERIES B-STATISTICAL METHODOLOGY = J ROY STAT SOC B
JOURNAL OF THE ROYAL STATISTICAL SOCIETY SERIES C-APPLIED STATISTICS = J ROY STAT SOC C-APP
JOURNAL OF THE ROYAL STATISTICAL SOCIETY SERIES D-THE STATISTICIAN = J ROY STAT SOC D-STA
JOURNAL OF THE RUBBER RESEARCH INSTITUTE OF MALAYSIA = J RUBBER RES I MALAY
JOURNAL OF THE SCIENCE OF FOOD AND AGRICULTURE = J SCI FOOD AGR
JOURNAL OF THE SCIENCE SOCIETY OF THAILAND = J SCI SOC THAILAND
JOURNAL OF THE SCIENTIFIC AGRICULTURAL SOCIETY OF FINLAND = J AGR SCI FINLAND
JOURNAL OF THE SERBIAN CHEMICAL SOCIETY = J SERB CHEM SOC
JOURNAL OF THE SOCIETY FOR GYNECOLOGIC INVESTIGATION = J SOC GYNECOL INVEST
JOURNAL OF THE SOCIETY OF ARCHITECTURAL HISTORIANS = J SOC ARCHIT HIST
JOURNAL OF THE SOCIETY OF ARCHIVISTS = J SOC ARCHIVISTS
JOURNAL OF THE SOCIETY OF COSMETIC CHEMISTS = J SOC COSMET CHEM
JOURNAL OF THE SOCIETY OF DAIRY TECHNOLOGY = J SOC DAIRY TECHNOL
JOURNAL OF THE SOCIETY OF DYERS AND COLOURISTS = J SOC DYERS COLOUR
JOURNAL OF THE SOCIETY OF LEATHER TECHNOLOGISTS AND CHEMISTS = J SOC LEATH TECH CH
JOURNAL OF THE SOCIETY OF OCCUPATIONAL MEDICINE = J SOC OCCUP MED
JOURNAL OF THE SOUTH AFRICAN INSTITUTE OF MINING AND METALLURGY = J S AFR I MIN METALL
JOURNAL OF THE SOUTH AFRICAN VETERINARY ASSOCIATION-TYDSKRIF VAN DIE SUID-AFRIKAANSE VETERINERE VERENIGING = J S AFR VET ASSOC
JOURNAL OF THE SOUTHWEST = J SOUTHWEST
JOURNAL OF THE STRUCTURAL DIVISION-ASCE = J STRUCT DIV-ASCE
JOURNAL OF THE SURVEYING AND MAPPING DIVISION-ASCE = J SURV ENG DIV-ASCE
JOURNAL OF THE TENNESSEE MEDICAL ASSOCIATION = J TENNESSEE MED ASS
JOURNAL OF THE TEXTILE INSTITUTE = J TEXT I
JOURNAL OF THE TORREY BOTANICAL SOCIETY = J TORREY BOT SOC
JOURNAL OF THE UNIVERSITY OF KUWAIT-SCIENCE = J U KUWAIT-SCI
JOURNAL OF THE URBAN PLANNING & DEVELOPMENT DIVISION-ASCE = J URBAN PLAN DEV DIV
JOURNAL OF THE WARBURG AND COURTAULD INSTITUTES = J WARBURG COURTAULD
JOURNAL OF THE WATERWAY PORT COASTAL AND OCEAN DIVISION-ASCE = J WATERW PORT C DIV
JOURNAL OF THE WEST = J WEST
JOURNAL OF THE WORLD AQUACULTURE SOCIETY = J WORLD AQUACULT SOC
JOURNAL OF THEOLOGICAL STUDIES = J THEOL STUD
JOURNAL OF THEORETICAL BIOLOGY = J THEOR BIOL
JOURNAL OF THEORETICAL NEUROBIOLOGY = J THEOR NEUROBIOL
JOURNAL OF THEORETICAL POLITICS = J THEOR POLIT
JOURNAL OF THEORETICAL PROBABILITY = J THEOR PROBAB
JOURNAL OF THERMAL ANALYSIS = J THERM ANAL
JOURNAL OF THERMAL ANALYSIS AND CALORIMETRY = J THERM ANAL CALORIM
JOURNAL OF THERMAL BIOLOGY = J THERM BIOL
JOURNAL OF THERMAL SPRAY TECHNOLOGY = J THERM SPRAY TECHN
JOURNAL OF THERMAL STRESSES = J THERM STRESSES
JOURNAL OF THERMOPHYSICS AND HEAT TRANSFER = J THERMOPHYS HEAT TR
JOURNAL OF THERMOPLASTIC COMPOSITE MATERIALS = J THERMOPLAST COMPOS
JOURNAL OF THORACIC AND CARDIOVASCULAR SURGERY = J THORAC CARDIOV SUR
JOURNAL OF THORACIC IMAGING = J THORAC IMAG
JOURNAL OF THROMBOSIS AND THROMBOLYSIS = J THROMB THROMBOLYS
JOURNAL OF TOXICOLOGY AND ENVIRONMENTAL HEALTH = J TOXICOL ENV HEALTH
JOURNAL OF TOXICOLOGY AND ENVIRONMENTAL HEALTH-PART A = J TOXICOL ENV HEAL A
JOURNAL OF TOXICOLOGY AND ENVIRONMENTAL HEALTH-PART B-CRITICAL REVIEWS = J TOXICOL ENV HEAL B
JOURNAL OF TOXICOLOGY-CLINICAL TOXICOLOGY = J TOXICOL-CLIN TOXIC
JOURNAL OF TOXICOLOGY-CUTANEOUS AND OCULAR TOXICOLOGY = J TOXICOL-CUTAN OCUL
JOURNAL OF TOXICOLOGY-TOXIN REVIEWS = J TOXICOL-TOXIN REV
JOURNAL OF TRACE AND MICROPROBE TECHNIQUES = J TRACE MICROPROBE T
JOURNAL OF TRACE ELEMENTS AND ELECTROLYTES IN HEALTH AND DISEASE = J TRACE ELEM ELECT H
JOURNAL OF TRACE ELEMENTS IN EXPERIMENTAL MEDICINE = J TRACE ELEM EXP MED
JOURNAL OF TRACE ELEMENTS IN MEDICINE AND BIOLOGY = J TRACE ELEM MED BIO
JOURNAL OF TRANSPERSONAL PSYCHOLOGY = J TRANSPERSONAL PSY
JOURNAL OF TRANSPORT ECONOMICS AND POLICY = J TRANSP ECON POLICY
JOURNAL OF TRANSPORTATION ENGINEERING-ASCE = J TRANSP ENG-ASCE
JOURNAL OF TRAUMA-INJURY INFECTION AND CRITICAL CARE = J TRAUMA
JOURNAL OF TRAUMATIC STRESS = J TRAUMA STRESS
JOURNAL OF TRAVEL MEDICINE = J TRAVEL MED
JOURNAL OF TRIBOLOGY-TRANSACTIONS OF THE ASME = J TRIBOL-T ASME
JOURNAL OF TROPICAL ECOLOGY = J TROP ECOL
JOURNAL OF TROPICAL MEDICINE AND HYGIENE = J TROP MED HYG
JOURNAL OF TROPICAL PEDIATRICS = J TROP PEDIATRICS
JOURNAL OF TUMOR MARKER ONCOLOGY = J TUMOR MARKER ONCOL
JOURNAL OF TURBOMACHINERY-TRANSACTIONS OF THE ASME = J TURBOMACH
JOURNAL OF ULTRASOUND IN MEDICINE = J ULTRAS MED
JOURNAL OF ULTRASTRUCTURE AND MOLECULAR STRUCTURE RESEARCH = J ULTRA MOL STRUCT R
JOURNAL OF ULTRASTRUCTURE RESEARCH = J ULTRA MOL STRUCT R
JOURNAL OF UNIVERSITY OF SCIENCE AND TECHNOLOGY BEIJING = J UNIV SCI TECHNOL B
JOURNAL OF URBAN AFFAIRS = J URBAN AFF
JOURNAL OF URBAN ECONOMICS = J URBAN ECON
JOURNAL OF URBAN HEALTH-BULLETIN OF THE NEW YORK ACADEMY OF MEDICINE = J URBAN HEALTH
JOURNAL OF URBAN HISTORY = J URBAN HIST
JOURNAL OF URBAN PLANNING AND DEVELOPMENT-ASCE = J URBAN PLAN D-ASCE
JOURNAL OF URBAN TECHNOLOGY = J URBAN TECHNOL
JOURNAL OF UROLOGY = J UROLOGY
JOURNAL OF VACUUM SCIENCE & TECHNOLOGY = J VAC SCI TECHNOL
JOURNAL OF VACUUM SCIENCE & TECHNOLOGY A-VACUUM SURFACES AND FILMS = J VAC SCI TECHNOL A
JOURNAL OF VACUUM SCIENCE & TECHNOLOGY B = J VAC SCI TECHNOL B
JOURNAL OF VALUE INQUIRY = J VALUE INQUIRY
JOURNAL OF VASCULAR AND INTERVENTIONAL RADIOLOGY = J VASC INTERV RADIOL
JOURNAL OF VASCULAR RESEARCH = J VASC RES
JOURNAL OF VASCULAR SURGERY = J VASC SURG
JOURNAL OF VECTOR ECOLOGY = J VECTOR ECOL
JOURNAL OF VEGETATION SCIENCE = J VEG SCI
JOURNAL OF VERTEBRATE PALEONTOLOGY = J VERTEBR PALEONTOL
JOURNAL OF VESTIBULAR RESEARCH-EQUILIBRIUM & ORIENTATION = J VESTIBUL RES-EQUIL
JOURNAL OF VETERINARY DIAGNOSTIC INVESTIGATION = J VET DIAGN INVEST
JOURNAL OF VETERINARY INTERNAL MEDICINE = J VET INTERN MED
JOURNAL OF VETERINARY MEDICAL EDUCATION = J VET MED EDUC
JOURNAL OF VETERINARY MEDICAL SCIENCE = J VET MED SCI
JOURNAL OF VETERINARY MEDICINE SERIES A-PHYSIOLOGY PATHOLOGY CLINICAL MEDICINE = J VET MED A
JOURNAL OF VETERINARY MEDICINE SERIES A-ZENTRALBLATT FUR VETERINARMEDIZIN REIHE A-PHYSIOLOGY PATHOLOGY CLINICAL MEDICINE = J VET MED A
JOURNAL OF VETERINARY MEDICINE SERIES B-INFECTIOUS DISEASES AND VETERINARY PUBLIC HEALTH = J VET MED B
JOURNAL OF VETERINARY MEDICINE SERIES B-ZENTRALBLATT FUR VETERINARMEDIZIN REIHE B-INFECTIOUS DISEASES AND VETERINARY PUBLIC HEALTH = J VET MED B
JOURNAL OF VETERINARY PHARMACOLOGY AND THERAPEUTICS = J VET PHARMACOL THER
JOURNAL OF VIBRATION ACOUSTICS STRESS AND RELIABILITY IN DESIGN-TRANSACTIONS OF THE ASME = J VIB ACOUST
JOURNAL OF VIBRATION ACOUSTICS STRESS AND RELIABILITY IN DESIGN-TRANSACTIONS OF THE ASME = J VIB ACOUST STRESS
JOURNAL OF VIBRATION AND ACOUSTICS-TRANSACTIONS OF THE ASME = J VIB ACOUST
JOURNAL OF VIBRATION AND CONTROL = J VIB CONTROL
JOURNAL OF VINYL & ADDITIVE TECHNOLOGY = J VINYL ADDIT TECHN
JOURNAL OF VIRAL HEPATITIS = J VIRAL HEPATITIS
JOURNAL OF VIROLOGICAL METHODS = J VIROL METHODS
JOURNAL OF VIROLOGY = J VIROL
JOURNAL OF VISUAL COMMUNICATION AND IMAGE REPRESENTATION = J VIS COMMUN IMAGE R
JOURNAL OF VISUAL IMPAIRMENT & BLINDNESS = J VISUAL IMPAIR BLIN
JOURNAL OF VISUAL LANGUAGES AND COMPUTING = J VISUAL LANG COMPUT
JOURNAL OF VISUALIZATION AND COMPUTER ANIMATION = J VISUAL COMP ANIMAT
JOURNAL OF VLSI AND COMPUTER SYSTEMS = J VLSI COMPUT SYST
JOURNAL OF VLSI SIGNAL PROCESSING = J VLSI SIGNAL PROC
JOURNAL OF VLSI SIGNAL PROCESSING SYSTEMS FOR SIGNAL IMAGE AND VIDEO TECHNOLOGY = J VLSI SIG PROCESS S
JOURNAL OF VOCATIONAL BEHAVIOR = J VOCAT BEHAV
JOURNAL OF VOICE = J VOICE
JOURNAL OF VOLCANOLOGY AND GEOTHERMAL RESEARCH = J VOLCANOL GEOTH RES
JOURNAL OF WATER RESOURCES PLANNING AND MANAGEMENT-ASCE = J WATER RES PL-ASCE
JOURNAL OF WATER SERVICES RESEARCH AND TECHNOLOGY-AQUA = J WATER SERV RES TEC
JOURNAL OF WATER SUPPLY RESEARCH AND TECHNOLOGY-AQUA = J WATER SUPPLY RES T
JOURNAL OF WATERWAY PORT COASTAL AND OCEAN ENGINEERING-ASCE = J WATERW PORT C-ASCE
JOURNAL OF WILDERNESS MEDICINE = J WILDERNESS MED
JOURNAL OF WILDLIFE DISEASES = J WILDLIFE DIS
JOURNAL OF WILDLIFE MANAGEMENT = J WILDLIFE MANAGE
JOURNAL OF WILDLIFE REHABILITATION = J WILDLIFE REHABIL
JOURNAL OF WIND ENGINEERING AND INDUSTRIAL AERODYNAMICS = J WIND ENG IND AEROD
JOURNAL OF WOMEN & AGING = J WOMEN AGING
JOURNAL OF WOMENS HEALTH = J WOMENS HEALTH
JOURNAL OF WOMENS HEALTH & GENDER-BASED MEDICINE = J WOMEN HEALTH GEN-B
JOURNAL OF WOMENS HISTORY = J WOMENS HIST
JOURNAL OF WOOD CHEMISTRY AND TECHNOLOGY = J WOOD CHEM TECHNOL
JOURNAL OF WOOD SCIENCE = J WOOD SCI
JOURNAL OF WORLD BUSINESS = J WORLD BUS
JOURNAL OF WORLD HISTORY = J WORLD HIST
JOURNAL OF WORLD PREHISTORY = J WORLD PREHIST
JOURNAL OF WORLD TRADE = J WORLD TRADE
JOURNAL OF WUHAN UNIVERSITY OF TECHNOLOGY-MATERIALS SCIENCE EDITION = J WUHAN UNIV TECHNOL
JOURNAL OF YOUTH AND ADOLESCENCE = J YOUTH ADOLESCENCE
JOURNAL OF ZOO AND WILDLIFE MEDICINE = J ZOO WILDLIFE MED
JOURNAL OF ZOO ANIMAL MEDICINE = J ZOO ANIM MED
JOURNAL OF ZOO ANIMAL MEDICINE = J ZOO WILDLIFE MED
JOURNAL OF ZOOLOGICAL SYSTEMATICS AND EVOLUTIONARY RESEARCH = J ZOOL SYST EVOL RES
JOURNAL OF ZOOLOGY = J ZOOL
JOURNAL PRESTRESSED CONCRETE INSTITUTE = J PRESTR CONCRETE I
JOURNAL WATER POLLUTION CONTROL FEDERATION = J WATER POLLUT CON F
JOURNALISM & MASS COMMUNICATION QUARTERLY = JOURNALISM MASS COMM
JOURNALISM QUARTERLY = JOURNALISM QUART
JOURNALS OF GERONTOLOGY = J GERONTOL
JOURNALS OF GERONTOLOGY SERIES A-BIOLOGICAL SCIENCES AND MEDICAL SCIENCES = J GERONTOL A-BIOL
JOURNALS OF GERONTOLOGY SERIES B-PSYCHOLOGICAL SCIENCES AND SOCIAL SCIENCES = J GERONTOL B-PSYCHOL
JPC-JOURNAL OF PLANAR CHROMATOGRAPHY-MODERN TLC = JPC-J PLANAR CHROMAT
JSAE REVIEW = JSAE REV
JSME INTERNATIONAL JOURNAL = JSME INT J
JSME INTERNATIONAL JOURNAL SERIES A-MECHANICS AND MATERIAL ENGINEERING = JSME INT J A-MECH M
JSME INTERNATIONAL JOURNAL SERIES A-SOLID MECHANICS AND MATERIAL ENGINEERING = JSME INT J A-SOLID M
JSME INTERNATIONAL JOURNAL SERIES B-FLUIDS AND THERMAL ENGINEERING = JSME INT J B-FLUID T
JSME INTERNATIONAL JOURNAL SERIES C-DYNAMICS CONTROL ROBOTICS DESIGN AND MANUFACTURING = JSME INT J C-DYN CON
JSME INTERNATIONAL JOURNAL SERIES C-MECHANICAL SYSTEMS MACHINE ELEMENTS AND MANUFACTURING = JSME INT J C-MECH SY
JSME INTERNATIONAL JOURNAL SERIES I-SOLID MECHANICS STRENGTH OF MATERIALS = JSME INT J I-SOLID M
JSME INTERNATIONAL JOURNAL SERIES II-FLUIDS ENGINEERING HEAT TRANSFER POWER COMBUSTION THERMOPHYSICAL PROPERTIES = JSME INT J II-FLUID
JSME INTERNATIONAL JOURNAL SERIES III-VIBRATION CONTROL ENGINEERING ENGINEERING FOR INDUSTRY = JSME INT J III-VIB C
JUDAISM = JUDAISM
JUDICATURE = JUDICATURE
JUGOSLOVENSKA MEDICINSKA BIOHEMIJA-YUGOSLAV MEDICAL BIOCHEMISTRY = JUGOSLAV MED BIOHEM
JUSTICE QUARTERLY = JUSTICE Q
JUSTICE SYSTEM JOURNAL = JUSTICE SYST J
JUVENILE & FAMILY COURT JOURNAL = JUVENILE FAM COURT J
JUVENILE AND FAMILY COURT JOURNAL = JUVENILE FAM COURT J
