K-THEORY = K-THEORY
KAGAKU KOGAKU RONBUNSHU = KAGAKU KOGAKU RONBUN
KALIKASAN-THE PHILIPPINE JOURNAL OF BIOLOGY = KALIKASAN
KALTE UND KLIMATECHNIK = KALTE KLIMATECHNIK
KANSAS AGRICULTURAL EXPERIMENT STATION BULLETIN = KANS AES BULL
KANSAS AGRICULTURAL EXPERIMENT STATION RESEARCH PUBLICATION = KANS AES RES PUBL
KANT-STUDIEN = KANT-STUD
KARDIOLOGIYA = KARDIOLOGIYA
KAUTSCHUK GUMMI KUNSTSTOFFE = KAUT GUMMI KUNSTST
KEATS-SHELLEY JOURNAL = KEATS-SHELLEY J
KEATS-SHELLEY REVIEW = KEATS-SHELLEY REV
KEMIAI KOZLEMENYEK = KEM KOZL
KEMISK TIDSKRIFT = KEM TIDSKR
KENNEDY INSTITUTE OF ETHICS JOURNAL = KENNEDY INST ETHIC J
KENYON REVIEW = KENYON REV
KERNENERGIE = KERNENERGIE
KERNTECHNIK = KERNTECHNIK
KEXUE TONGBAO = KEXUE TONGBAO
KEY ENGINEERING MATERIALS = KEY ENG MAT
KHIMICHESKAYA FIZIKA = KHIM FIZ
KHIMICHESKAYA PROMYSHLENNOST = KHIM PROMST+
KHIMIKO-FARMATSEVTICHESKII ZHURNAL = KHIM FARM ZH+
KHIMIYA GETEROTSIKLICHESKIKH SOEDINENII = KHIM GETEROTSIKL+
KHIMIYA PRIRODNYKH SOEDINENII = KHIM PRIR SOEDIN+
KHIRURGIYA = KHIRURGIYA
KIDNEY & BLOOD PRESSURE RESEARCH = KIDNEY BLOOD PRESS R
KIDNEY INTERNATIONAL = KIDNEY INT
KIELER MILCHWIRTSCHAFTLICHE FORSCHUNGSBERICHTE = KIELER MILCHW FORSCH
KINETICS AND CATALYSIS = KINET CATAL+
KING FAISAL SPECIALIST HOSPITAL MEDICAL JOURNAL = K F SPEC HOSP MED J
KLEINTIERPRAXIS = KLEINTIERPRAXIS
KLINICHESKAYA MEDITSINA = KLIN MED MOSCOW+
KLINISCHE MONATSBLATTER FUR AUGENHEILKUNDE = KLIN MONATSBL AUGENH
KLINISCHE NEUROPHYSIOLOGIE = KLIN NEUROPHYSIOL
KLINISCHE PADIATRIE = KLIN PADIATR
KLINISCHE WOCHENSCHRIFT = KLIN WOCHENSCHR
KNEE = KNEE
KNEE SURGERY SPORTS TRAUMATOLOGY ARTHROSCOPY = KNEE SURG SPORT TR A
KNOWLEDGE ACQUISITION = KNOWL ACQUIS
KNOWLEDGE ENGINEERING REVIEW = KNOWL ENG REV
KNOWLEDGE ORGANIZATION = KNOWL ORGAN
KNOWLEDGE-BASED SYSTEMS = KNOWL-BASED SYST
KNOWLEDGE-CREATION DIFFUSION UTILIZATION = KNOWLEDGE
KOBUNSHI RONBUNSHU = KOBUNSHI RONBUNSHU
KODIKAS CODE-ARS SEMEIOTICA = KODIKAS CODE-ARS SEM
KOLNER ZEITSCHRIFT FUR SOZIOLOGIE UND SOZIALPSYCHOLOGIE = KOLNER Z SOZIOL SOZ
KONSTHISTORISK TIDSKRIFT = KONSTHIST TIDSKR
KOORDINATSIONNAYA KHIMIYA = KOORDINATS KHIM+
KOREA POLYMER JOURNAL = KOREA POLYM J
KOREAN JOURNAL OF BIOCHEMISTRY = KOREAN J BIOCHEM
KOREAN JOURNAL OF CHEMICAL ENGINEERING = KOREAN J CHEM ENG
KOREAN JOURNAL OF DEFENSE ANALYSIS = KOREAN J DEF ANAL
KOREAN JOURNAL OF GENETICS = KOREAN J GENETIC
KOSMICHESKAYA BIOLOGIYA I AVIAKOSMICHESKAYA MEDITSINA = KOSM BIOL AVIAK MED+
KOSMORAMA = KOSMORAMA
KOVOVE MATERIALY-METALLIC MATERIALS = KOVOVE MATER
KRIMINALISTIK = KRIMINALISTIK
KRISTALLOGRAFIYA = KRISTALLOGRAFIYA+
KSME INTERNATIONAL JOURNAL = KSME INT J
KSME JOURNAL = KSME J
KUNSTSTOFFE-GERMAN PLASTICS = KUNSTST-GER PLAST+
KUNSTSTOFFE-PLAST EUROPE = KUNSTST-PLAST EUR
KUWAIT JOURNAL OF SCIENCE & ENGINEERING = KUWAIT J SCI ENG
KVANTOVAYA ELEKTRONIKA = KVANTOVAYA ELEKTRON+
KYBERNETES = KYBERNETES
KYBERNETIKA = KYBERNETIKA
KYKLOS = KYKLOS
