QJM-MONTHLY JOURNAL OF THE ASSOCIATION OF PHYSICIANS = QJM-MON J ASSOC PHYS
QST = QST
QUADERNI D ITALIANISTICA = QUAD ITAL
QUADERNI MEDIEVALI = QUAD MEDIEVALI
QUADERNI STORICI = QUAD STORICI
QUALITAS PLANTARUM-PLANT FOODS FOR HUMAN NUTRITION = QUAL PLANT
QUALITATIVE HEALTH RESEARCH = QUAL HEALTH RES
QUALITY & QUANTITY = QUAL QUANT
QUALITY AND RELIABILITY ENGINEERING INTERNATIONAL = QUAL RELIAB ENG INT
QUALITY IN HEALTH CARE = QUAL HEALTH CARE
QUALITY OF LIFE RESEARCH = QUAL LIFE RES
QUALITY PROGRESS = QUAL PROG
QUANTITATIVE STRUCTURE-ACTIVITY RELATIONSHIPS = QUANT STRUCT-ACT REL
QUANTUM AND SEMICLASSICAL OPTICS = QUANTUM SEMICL OPT
QUANTUM ELECTRONICS = QUANTUM ELECTRON+
QUANTUM OPTICS = QUANTUM OPT
QUARTERLY JOURNAL OF ECONOMICS = Q J ECON
QUARTERLY JOURNAL OF ENGINEERING GEOLOGY = Q J ENG GEOL
QUARTERLY JOURNAL OF ENGINEERING GEOLOGY AND HYDROGEOLOGY = Q J ENG GEOL HYDROGE
QUARTERLY JOURNAL OF EXPERIMENTAL PHYSIOLOGY AND COGNATE MEDICAL SCIENCES = Q J EXP PHYSIOL CMS
QUARTERLY JOURNAL OF EXPERIMENTAL PSYCHOLOGY SECTION A-HUMAN EXPERIMENTAL PSYCHOLOGY = Q J EXP PSYCHOL-A
QUARTERLY JOURNAL OF EXPERIMENTAL PSYCHOLOGY SECTION B-COMPARATIVE AND PHYSIOLOGICAL PSYCHOLOGY = Q J EXP PSYCHOL-B
QUARTERLY JOURNAL OF FORESTRY = Q J FOREST
QUARTERLY JOURNAL OF MATHEMATICS = Q J MATH
QUARTERLY JOURNAL OF MECHANICS AND APPLIED MATHEMATICS = Q J MECH APPL MATH
QUARTERLY JOURNAL OF MEDICINE = Q J MED
QUARTERLY JOURNAL OF NUCLEAR MEDICINE = Q J NUCL MED
QUARTERLY JOURNAL OF SPEECH = Q J SPEECH
QUARTERLY JOURNAL OF THE ROYAL ASTRONOMICAL SOCIETY = Q J ROY ASTRON SOC
QUARTERLY JOURNAL OF THE ROYAL METEOROLOGICAL SOCIETY = Q J ROY METEOR SOC
QUARTERLY OF APPLIED MATHEMATICS = Q APPL MATH
QUARTERLY REVIEW OF BIOLOGY = Q REV BIOL
QUARTERLY REVIEW OF ECONOMICS AND FINANCE = Q REV ECON FINANC
QUARTERLY REVIEW OF FILM AND VIDEO = Q REV FILM VID
QUARTERLY REVIEWS OF BIOPHYSICS = Q REV BIOPHYS
QUATERNARY INTERNATIONAL = QUATERN INT
QUATERNARY RESEARCH = QUATERNARY RES
QUATERNARY SCIENCE REVIEWS = QUATERNARY SCI REV
QUEENS QUARTERLY = QUEENS QUART
QUEST = QUEST
QUEUEING SYSTEMS = QUEUEING SYST
QUIMICA ANALITICA = QUIM ANAL
QUIMICA NOVA = QUIM NOVA
QUINTESSENCE INTERNATIONAL = QUINTESSENCE INT
QUINZAINE LITTERAIRE = QUINZAINE LITTERAIRE
