SABOURAUDIA-JOURNAL OF MEDICAL AND VETERINARY MYCOLOGY = SABOURAUDIA
SACRED MUSIC = SACRED MUSIC
SADHANA-ACADEMY PROCEEDINGS IN ENGINEERING SCIENCES = SADHANA-ACAD P ENG S
SAECULUM = SAECULUM
SAFETY SCIENCE = SAFETY SCI
SAGGI-NEUROPSICOLOGIA INFANTILE PSICOPEDAGOGIA RIABILITAZIONE = SAGGI
SALMAGUNDI-A QUARTERLY OF THE HUMANITIES AND SOCIAL SCIENCES = SALMAGUNDI
SALUD MENTAL = SALUD MENT
SALUD PUBLICA DE MEXICO = SALUD PUBLICA MEXICO
SAMPE JOURNAL = SAMPE J
SAMPE QUARTERLY-SOCIETY FOR THE ADVANCEMENT OF MATERIAL AND PROCESS ENGINEERING = SAMPE QUART
SANKHYA-THE INDIAN JOURNAL OF STATISTICS SERIES A = SANKHYA SER A
SANKHYA-THE INDIAN JOURNAL OF STATISTICS SERIES B = SANKHYA SER B
SAR AND QSAR IN ENVIRONMENTAL RESEARCH = SAR QSAR ENVIRON RES
SARCOIDOSIS = SARCOIDOSIS
SARCOIDOSIS VASCULITIS AND DIFFUSE LUNG DISEASES = SARCOIDOSIS VASC DIF
SARSIA = SARSIA
SAUDI MEDICAL JOURNAL = SAUDI MED J
SBORNIK LEKARSKY = SB LEK
SBORNIK MATHEMATICS = SB MATH+
SBORNIK VYSOKE SKOLY CHEMICKO-TECHNOLOGICKE V PRAZE-POTRAVINY = SB VYS SK CHEM TECHN
SCANDINAVIAN AUDIOLOGY = SCAND AUDIOL
SCANDINAVIAN CARDIOVASCULAR JOURNAL = SCAND CARDIOVASC J
SCANDINAVIAN HOUSING & PLANNING RESEARCH = SCAND HOUS PLAN RES
SCANDINAVIAN JOURNAL OF CARING SCIENCES = SCAND J CARING SCI
SCANDINAVIAN JOURNAL OF CLINICAL & LABORATORY INVESTIGATION = SCAND J CLIN LAB INV
SCANDINAVIAN JOURNAL OF DENTAL RESEARCH = SCAND J DENT RES
SCANDINAVIAN JOURNAL OF ECONOMICS = SCAND J ECON
SCANDINAVIAN JOURNAL OF FOREST RESEARCH = SCAND J FOREST RES
SCANDINAVIAN JOURNAL OF GASTROENTEROLOGY = SCAND J GASTROENTERO
SCANDINAVIAN JOURNAL OF HAEMATOLOGY = SCAND J HAEMATOL
SCANDINAVIAN JOURNAL OF HISTORY = SCAND J HIST
SCANDINAVIAN JOURNAL OF IMMUNOLOGY = SCAND J IMMUNOL
SCANDINAVIAN JOURNAL OF INFECTIOUS DISEASES = SCAND J INFECT DIS
SCANDINAVIAN JOURNAL OF LABORATORY ANIMAL SCIENCE = SCAND J LAB ANIM SCI
SCANDINAVIAN JOURNAL OF MEDICINE & SCIENCE IN SPORTS = SCAND J MED SCI SPOR
SCANDINAVIAN JOURNAL OF METALLURGY = SCAND J METALL
SCANDINAVIAN JOURNAL OF PLASTIC AND RECONSTRUCTIVE SURGERY AND HAND SURGERY = SCAND J PLAST RECONS
SCANDINAVIAN JOURNAL OF PRIMARY HEALTH CARE = SCAND J PRIM HEALTH
SCANDINAVIAN JOURNAL OF PSYCHOLOGY = SCAND J PSYCHOL
SCANDINAVIAN JOURNAL OF PUBLIC HEALTH = SCAND J PUBLIC HEALT
SCANDINAVIAN JOURNAL OF REHABILITATION MEDICINE = SCAND J REHABIL MED
SCANDINAVIAN JOURNAL OF RHEUMATOLOGY = SCAND J RHEUMATOL
SCANDINAVIAN JOURNAL OF SOCIAL MEDICINE = SCAND J SOC MED
SCANDINAVIAN JOURNAL OF SOCIAL WELFARE = SCAND J SOC WELFARE
SCANDINAVIAN JOURNAL OF STATISTICS = SCAND J STAT
SCANDINAVIAN JOURNAL OF THORACIC AND CARDIOVASCULAR SURGERY = SCAND J THORAC CARD
SCANDINAVIAN JOURNAL OF UROLOGY AND NEPHROLOGY = SCAND J UROL NEPHROL
SCANDINAVIAN JOURNAL OF WORK ENVIRONMENT & HEALTH = SCAND J WORK ENV HEA
SCANDINAVIAN POLITICAL STUDIES = SCAND POLIT STUD
SCANDINAVIAN STUDIES = SCAND STUD
SCANDINAVICA = SCANDINAVICA
SCANNING = SCANNING
SCANNING ELECTRON MICROSCOPY = SCAN ELECTRON MICROS
SCANNING ELECTRON MICROSCOPY = SCANNING MICROSCOPY
SCANNING MICROSCOPY = SCANNING MICROSCOPY
SCHIZOPHRENIA BULLETIN = SCHIZOPHRENIA BULL
SCHIZOPHRENIA RESEARCH = SCHIZOPHR RES
SCHMERZ = SCHMERZ
SCHOLARLY PUBLISHING = SCHOLARLY PUBL
SCHOOL EFFECTIVENESS AND SCHOOL IMPROVEMENT = SCH EFF SCH IMPROV
SCHOOL PSYCHOLOGY INTERNATIONAL = SCHOOL PSYCHOL INT
SCHOOL PSYCHOLOGY QUARTERLY = SCHOOL PSYCHOL QUART
SCHOOL PSYCHOLOGY REVIEW = SCHOOL PSYCHOL REV
SCHWEIZER ARCHIV FUR NEUROLOGIE UND PSYCHIATRIE = SCHWEIZ ARCH NEUROL
SCHWEIZER ARCHIV FUR TIERHEILKUNDE = SCHWEIZ ARCH TIERH
SCHWEIZERISCHE MEDIZINISCHE WOCHENSCHRIFT = SCHWEIZ MED WSCHR
SCHWEIZERISCHE MINERALOGISCHE UND PETROGRAPHISCHE MITTEILUNGEN = SCHWEIZ MINER PETROG
SCHWEIZERISCHE RUNDSCHAU FUR MEDIZIN PRAXIS = SCHWEIZ RUNDSCH MED
SCHWEIZERISCHE ZEITSCHRIFT FUR HYDROLOGIE-SWISS JOURNAL OF HYDROLOGY = SCHWEIZ Z HYDROL
SCHWEIZERISCHE ZEITSCHRIFT FUR PSYCHOLOGIE-REVUE SUISSE DE PSYCHOLOGIE = SCHWEIZ Z PSYCHOL
SCHWEIZERISCHES ARCHIV FUR VOLKSKUNDE = SCHWEIZ ARCH VOLKSKU
SCIENCE = SCIENCE
SCIENCE & JUSTICE = SCI JUSTICE
SCIENCE & SOCIETY = SCI SOC
SCIENCE & SPORTS = SCI SPORT
SCIENCE & TECHNOLOGY LIBRARIES = SCI TECH LIBR
SCIENCE 83 = SCIENCE 85
SCIENCE 84 = SCIENCE 85
SCIENCE 85 = SCIENCE 85
SCIENCE AND EDUCATION ADMINISTRATION PUBLICATIONS = SCI EDUC ADMIN PUBL
SCIENCE AND ENGINEERING ETHICS = SCI ENG ETHICS
SCIENCE AND ENGINEERING OF COMPOSITE MATERIALS = SCI ENG COMPOS MATER
SCIENCE AND TECHNOLOGY OF WELDING AND JOINING = SCI TECHNOL WELD JOI
SCIENCE BULLETIN OF THE FACULTY OF AGRICULTURE KYUSHU UNIVERSITY = SCI B FAC AGR KYUSHU
SCIENCE COMMUNICATION = SCI COMMUN
SCIENCE DIGEST = SCI DIG
SCIENCE EDUCATION = SCI EDUC
SCIENCE IN CHINA SERIES A-MATHEMATICS PHYSICS ASTRONOMY = SCI CHINA SER A
SCIENCE IN CHINA SERIES A-MATHEMATICS PHYSICS ASTRONOMY & TECHNOLOGICAL SCIENCES = SCI CHINA SER A
SCIENCE IN CHINA SERIES B-CHEMISTRY = SCI CHINA SER B
SCIENCE IN CHINA SERIES B-CHEMISTRY LIFE SCIENCES & EARTH SCIENCES = SCI CHINA SER B
SCIENCE IN CHINA SERIES C-LIFE SCIENCES = SCI CHINA SER C
SCIENCE IN CHINA SERIES D-EARTH SCIENCES = SCI CHINA SER D
SCIENCE IN CHINA SERIES E-TECHNOLOGICAL SCIENCES = SCI CHINA SER E
SCIENCE IN CONTEXT = SCI CONTEXT
SCIENCE NEWS = SCI NEWS
SCIENCE OF COMPUTER PROGRAMMING = SCI COMPUT PROGRAM
SCIENCE OF THE TOTAL ENVIRONMENT = SCI TOTAL ENVIRON
SCIENCE PROGRESS = SCI PROG
SCIENCE REPORTS OF THE RESEARCH INSTITUTES TOHOKU UNIVERSITY SERIES A-PHYSICS CHEMISTRY AND METALLURGY = SCI REP RES TOHOKU A
SCIENCE TECHNOLOGY & HUMAN VALUES = SCI TECHNOL HUM VAL
SCIENCE-FICTION STUDIES = SCI-FICTION STUD
SCIENCES DES ALIMENTS = SCI ALIMENT
SCIENCES ET TECHNIQUES DE L ANIMAL DE LABORATOIRE = SCI TECH ANIM LAB
SCIENCES ET TECHNIQUES DE L EAU = SCI TECH EAU
SCIENCES SOCIALES ET SANTE = SCI SOC SANTE
SCIENCES-NEW YORK = SCIENCES
SCIENTIA GEOLOGICA SINICA = SCI GEOL SINICA
SCIENTIA HORTICULTURAE = SCI HORTIC-AMSTERDAM
SCIENTIA MARINA = SCI MAR
SCIENTIA SINICA = SCI SINICA
SCIENTIA SINICA SERIES A-MATHEMATICAL PHYSICAL ASTRONOMICAL & TECHNICAL SCIENCES = SCI CHINA SER A
SCIENTIA SINICA SERIES A-MATHEMATICAL PHYSICAL ASTRONOMICAL & TECHNICAL SCIENCES = SCI SIN A-MATH P A T
SCIENTIA SINICA SERIES B-CHEMICAL BIOLOGICAL AGRICULTURAL MEDICAL & EARTH SCIENCES = SCI CHINA SER B
SCIENTIA SINICA SERIES B-CHEMICAL BIOLOGICAL AGRICULTURAL MEDICAL & EARTH SCIENCES = SCI SIN B-CHEM B A M
SCIENTIFIC AMERICAN = SCI AM
SCIENTIFIC HORTICULTURE = SCI HORTIC-ENGLAND
SCIENTIST = SCIENTIST
SCIENTOMETRICS = SCIENTOMETRICS
SCOTIA-INTERDISCIPLINARY JOURNAL OF SCOTTISH STUDIES = SCOTIA-INTERDISC J S
SCOTTISH GEOGRAPHICAL JOURNAL = SCOTT GEOGR J
SCOTTISH GEOGRAPHICAL MAGAZINE = SCOT GEOGR MAG
SCOTTISH HISTORICAL REVIEW = SCOT HIST REV
SCOTTISH JOURNAL OF GEOLOGY = SCOT J GEOL
SCOTTISH JOURNAL OF POLITICAL ECONOMY = SCOT J POLIT ECON
SCOTTISH JOURNAL OF THEOLOGY = SCOT J THEOLOGY
SCOTTISH LITERARY JOURNAL = SCOT LITERARY J
SCOTTISH MEDICAL JOURNAL = SCOT MED J
SCREEN = SCREEN
SCREENING = SCREENING
SCRIBLERIAN AND THE KIT-CATS = SCRIBLERIAN KIT-CATS
SCRIPTA MATERIALIA = SCRIPTA MATER
SCRIPTA METALLURGICA = SCRIPTA METALL MATER
SCRIPTA METALLURGICA ET MATERIALIA = SCRIPTA METALL MATER
SCRIPTORIUM = SCRIPTORIUM
SCULPTURE REVIEW = SCULPT REV
SEA FRONTIERS = SEA FRONTIERS
SEA TECHNOLOGY = SEA TECHNOL
SEARCH = SEARCH
SEARCHER-THE MAGAZINE FOR DATABASE PROFESSIONALS = SEARCHER
SECOND MESSENGERS AND PHOSPHOPROTEINS = SEC MESS PHOSPHOPROT
SECURITIES REGULATION LAW JOURNAL = SECUR REGUL LAW J
SECURITY DIALOGUE = SECUR DIALOGUE
SECURITY STUDIES = SECUR STUD
SEDIMENTARY GEOLOGY = SEDIMENT GEOL
SEDIMENTOLOGY = SEDIMENTOLOGY
SEED SCIENCE AND TECHNOLOGY = SEED SCI TECHNOL
SEED SCIENCE RESEARCH = SEED SCI RES
SEFARAD = SEFARAD
SEIBUTSU-KOGAKU KAISHI = SEIBUTSU-KOGAKU KAIS
SEIBUTSU-KOGAKU KAISHI-JOURNAL OF THE SOCIETY FOR FERMENTATION AND BIOENGINEERING = SEIBUTSU-KOGAKU KAIS
SEIKAGAKU = SEIKAGAKU
SEIZURE = SEIZURE
SEIZURE-EUROPEAN JOURNAL OF EPILEPSY = SEIZURE-EUR J EPILEP
SEKIYU GAKKAISHI-JOURNAL OF THE JAPAN PETROLEUM INSTITUTE = SEKIYU GAKKAISHI
SELECTIVE CANCER THERAPEUTICS = SELECT CANCER THER
SELECTIVE ELECTRODE REVIEWS = SELECT ELECTR REV
SELF-ASSEMBLED INGAAS/GAAS QUANTUM DOTS = SEMICONDUCT SEMIMET
SEMAINE DES HOPITAUX = SEM HOP PARIS
SEMEIA = SEMEIA
SEMICONDUCTOR SCIENCE AND TECHNOLOGY = SEMICOND SCI TECH
SEMICONDUCTORS = SEMICONDUCTORS+
SEMICONDUCTORS AND INSULATORS = SEMICOND INSUL
SEMICONDUCTORS AND SEMIMETALS = SEMICONDUCT SEMIMET
SEMIGROUP FORUM = SEMIGROUP FORUM
SEMINAR-A JOURNAL OF GERMANIC STUDIES = SEMINAR-J GER STUD
SEMINARS IN ANESTHESIA = SEMIN ANESTH
SEMINARS IN ARTHRITIS AND RHEUMATISM = SEMIN ARTHRITIS RHEU
SEMINARS IN AVIAN AND EXOTIC PET MEDICINE = SEMIN AVIAN EXOT PET
SEMINARS IN CANCER BIOLOGY = SEMIN CANCER BIOL
SEMINARS IN CELL & DEVELOPMENTAL BIOLOGY = SEMIN CELL DEV BIOL
SEMINARS IN CELL BIOLOGY = SEMIN CELL BIOL
SEMINARS IN CUTANEOUS MEDICINE AND SURGERY = SEMIN CUTAN MED SURG
SEMINARS IN DERMATOLOGY = SEMIN DERMATOL
SEMINARS IN DIAGNOSTIC PATHOLOGY = SEMIN DIAGN PATHOL
SEMINARS IN DIALYSIS = SEMIN DIALYSIS
SEMINARS IN HEMATOLOGY = SEMIN HEMATOL
SEMINARS IN IMMUNOLOGY = SEMIN IMMUNOL
SEMINARS IN INTERVENTIONAL RADIOLOGY = SEMIN INTERVENT RAD
SEMINARS IN LIVER DISEASE = SEMIN LIVER DIS
SEMINARS IN NEPHROLOGY = SEMIN NEPHROL
SEMINARS IN NEUROLOGY = SEMIN NEUROL
SEMINARS IN NEUROSCIENCE = SEMIN NEUROSCI
SEMINARS IN NUCLEAR MEDICINE = SEMIN NUCL MED
SEMINARS IN ONCOLOGY = SEMIN ONCOL
SEMINARS IN PERINATOLOGY = SEMIN PERINATOL
SEMINARS IN RADIATION ONCOLOGY = SEMIN RADIAT ONCOL
SEMINARS IN REPRODUCTIVE ENDOCRINOLOGY = SEMIN REPROD ENDOCR
SEMINARS IN RESPIRATORY AND CRITICAL CARE MEDICINE = SEM RESP CRIT CARE M
SEMINARS IN RESPIRATORY MEDICINE = SEMIN RESPIR MED
SEMINARS IN ROENTGENOLOGY = SEMIN ROENTGENOL
SEMINARS IN SURGICAL ONCOLOGY = SEMIN SURG ONCOL
SEMINARS IN THE NEUROSCIENCES = SEMIN NEUROSCI
SEMINARS IN THROMBOSIS AND HEMOSTASIS = SEMIN THROMB HEMOST
SEMINARS IN ULTRASOUND CT AND MRI = SEMIN ULTRASOUND CT
SEMINARS IN VETERINARY MEDICINE AND SURGERY-SMALL ANIMAL = SEMIN VET MED SURG
SEMINARS IN VIROLOGY = SEMIN VIROL
SEMIOTICA = SEMIOTICA
SEN-I GAKKAISHI = SEN-I GAKKAISHI
SENSORS AND ACTUATORS = SENSOR ACTUATOR
SENSORS AND ACTUATORS A-PHYSICAL = SENSOR ACTUAT A-PHYS
SENSORS AND ACTUATORS B-CHEMICAL = SENSOR ACTUAT B-CHEM
SENSORS AND MATERIALS = SENSOR MATER
SEPARATION AND PURIFICATION METHODS = SEPAR PURIF METHOD
SEPARATION AND PURIFICATION TECHNOLOGY = SEP PURIF TECHNOL
SEPARATION SCIENCE AND TECHNOLOGY = SEPAR SCI TECHNOL
SEPARATIONS TECHNOLOGY = SEPAR TECHNOL
SERIALS LIBRARIAN = SERIALS LIBR
SERODIAGNOSIS AND IMMUNOTHERAPY IN INFECTIOUS DISEASE = SERODIAG IMMUN INF D
SERVICE INDUSTRIES JOURNAL = SERV IND J
SET-VALUED ANALYSIS = SET-VALUED ANAL
SEVENTEENTH CENTURY = SEVENTEENTH CENT
SEVENTEENTH-CENTURY FRENCH STUDIES = SEVENTEEN-CENT FR ST
SEWANEE REVIEW = SEWANEE REV
SEX ROLES = SEX ROLES
SEXUAL PLANT REPRODUCTION = SEX PLANT REPROD
SEXUALITY AND DISABILITY = SEX DISABIL
SEXUALLY TRANSMITTED DISEASES = SEX TRANSM DIS
SEXUALLY TRANSMITTED INFECTIONS = SEX TRANSM INFECT
SEYBOLD OUTLOOK ON PROFESSIONAL COMPUTING = ANDREW SEYBOLD OUT P
SEYBOLD REPORT ON PROFESSIONAL COMPUTING = ANDREW SEYBOLD OUT P
SHAKESPEARE QUARTERLY = SHAKESPEARE QUART
SHAKESPEARE SURVEY = SHAKESPEARE SURV
SHARP TECHNICAL JOURNAL = SHARP TECH J
SHENANDOAH = SHENANDOAH
SHOCK = SHOCK
SHOCK AND VIBRATION = SHOCK VIB
SHOCK WAVES = SHOCK WAVES
SIAM JOURNAL ON ALGEBRAIC AND DISCRETE METHODS = SIAM J ALGEBRA DISCR
SIAM JOURNAL ON APPLIED MATHEMATICS = SIAM J APPL MATH
SIAM JOURNAL ON COMPUTING = SIAM J COMPUT
SIAM JOURNAL ON CONTROL AND OPTIMIZATION = SIAM J CONTROL OPTIM
SIAM JOURNAL ON DISCRETE MATHEMATICS = SIAM J DISCRETE MATH
SIAM JOURNAL ON MATHEMATICAL ANALYSIS = SIAM J MATH ANAL
SIAM JOURNAL ON MATRIX ANALYSIS AND APPLICATIONS = SIAM J MATRIX ANAL A
SIAM JOURNAL ON NUMERICAL ANALYSIS = SIAM J NUMER ANAL
SIAM JOURNAL ON OPTIMIZATION = SIAM J OPTIMIZ
SIAM JOURNAL ON SCIENTIFIC AND STATISTICAL COMPUTING = SIAM J SCI STAT COMP
SIAM JOURNAL ON SCIENTIFIC COMPUTING = SIAM J SCI COMPUT
SIAM REVIEW = SIAM REV
SIBERIAN MATHEMATICAL JOURNAL = SIBERIAN MATH J+
SIBIRSKII KHIMICHESKII ZHURNAL = SIBIRSKII KHIM ZH+
SIC MATERIALS AND DEVICES = SEMICONDUCT SEMIMET
SIEMENS FORSCHUNGS-UND ENTWICKLUNGSBERICHTE-SIEMENS RESEARCH AND DEVELOPMENT REPORTS = SIEMENS FORSCH ENTW
SIEMENS REVIEW = SIEMENS REV
SIERRA = SIERRA
SIGHT AND SOUND = SIGHT SOUND
SIGMOD RECORD = SIGMOD RECORD
SIGNAL PROCESSING = SIGNAL PROCESS
SIGNAL PROCESSING-IMAGE COMMUNICATION = SIGNAL PROCESS-IMAGE
SIGNS = SIGNS
SIGPLAN NOTICES = SIGPLAN NOTICES
SILICA: PHYSICAL BEHAVIOR, GEOCHEMISTRY AND MATERIALS APPLICATIONS = REV MINERAL
SILICATES INDUSTRIELS = SILIC IND
SILIKATY = SILIKATY
SILVA FENNICA = SILVA FENN
SILVAE GENETICA = SILVAE GENET
SIMIOLUS-NETHERLANDS QUARTERLY FOR THE HISTORY OF ART = SIMIOLUS
SIMULATION = SIMULATION
SIMULATION & GAMING = SIMULAT GAMING
SIMULATION PRACTICE AND THEORY = SIMULAT PRACT THEORY
SINGAPORE JOURNAL OF OBSTETRICS & GYNAECOLOGY = SINGAPORE J OBSTET
SINGAPORE JOURNAL OF TROPICAL GEOGRAPHY = SINGAPORE J TROP GEO
SINN UND FORM = SINN FORM
SIXTEENTH CENTURY JOURNAL = SIXTEENTH CENT J
SKANDINAVISTIK = SKANDINAVISTIK
SKELETAL RADIOLOGY = SKELETAL RADIOL
SKIN PHARMACOLOGY = SKIN PHARMACOL
SKIN PHARMACOLOGY AND APPLIED SKIN PHYSIOLOGY = SKIN PHARMACOL APPL
SKIN RESEARCH AND TECHNOLOGY = SKIN RES TECHNOL
SKULL BASE SURGERY = SKULL BASE SURG
SKY AND TELESCOPE = SKY TELESCOPE
SLAVIC AND EAST EUROPEAN JOURNAL = SLAVIC E EUR J
SLAVIC REVIEW = SLAVIC REV
SLAVONIC AND EAST EUROPEAN REVIEW = SLAVON E EUR REV
SLEEP = SLEEP
SLEEP MEDICINE REVIEWS = SLEEP MED REV
SLOAN MANAGEMENT REVIEW = SLOAN MANAGE REV
SMALL BUSINESS COMPUTER NEWS = SMALL BUS COMPUT NEW
SMALL BUSINESS COMPUTERS = SMALL BUS COMPUT
SMALL BUSINESS ECONOMICS = SMALL BUS ECON
SMALL GROUP RESEARCH = SMALL GR RES
SMALL RUMINANT RESEARCH = SMALL RUMINANT RES
SMART MATERIALS & STRUCTURES = SMART MATER STRUCT
SMITH COLLEGE STUDIES IN SOCIAL WORK = SMITH COLL STUD SOC
SMITHSONIAN = SMITHSONIAN
SMPTE JOURNAL = SMPTE J
SOAP & COSMETICS = SOAP COSMET
SOAP COSMETICS CHEMICAL SPECIALTIES = SOAP COSMET CHEM SPE
SOBORNOST INCORPORATING EASTERN CHURCHES REVIEW = SOBORNOST E CHURCH R
SOCIAL & LEGAL STUDIES = SOC LEGAL STUD
SOCIAL AND ECONOMIC STUDIES = SOC ECON STUD
SOCIAL BEHAVIOR AND PERSONALITY = SOC BEHAV PERSONAL
SOCIAL BIOLOGY = SOC BIOL
SOCIAL CHOICE AND WELFARE = SOC CHOICE WELFARE
SOCIAL COGNITION = SOC COGNITION
SOCIAL COMPASS = SOC COMPASS
SOCIAL DEVELOPMENT = SOC DEV
SOCIAL DYNAMICS-A JOURNAL OF THE CENTRE FOR AFRICAN STUDIES UNIVERSITY OF CAPE TOWN = SOC DYNAMICS
SOCIAL FORCES = SOC FORCES
SOCIAL HISTORY = SOC HIST
SOCIAL HISTORY OF MEDICINE = SOC HIST MED
SOCIAL INDICATORS RESEARCH = SOC INDIC RES
SOCIAL NETWORKS = SOC NETWORKS
SOCIAL PHILOSOPHY & POLICY = SOC PHILOS POLICY
SOCIAL POLICY & ADMINISTRATION = SOC POLICY ADMIN
SOCIAL POLITICS = SOC POLIT
SOCIAL PROBLEMS = SOC PROBL
SOCIAL PSYCHIATRY = SOC PSYCH PSYCH EPID
SOCIAL PSYCHIATRY = SOC PSYCHIATR
SOCIAL PSYCHIATRY AND PSYCHIATRIC EPIDEMIOLOGY = SOC PSYCH PSYCH EPID
SOCIAL PSYCHOLOGY QUARTERLY = SOC PSYCHOL QUART
SOCIAL RESEARCH = SOC RES
SOCIAL SCIENCE & MEDICINE = SOC SCI MED
SOCIAL SCIENCE COMPUTER REVIEW = SOC SCI COMPUT REV
SOCIAL SCIENCE HISTORY = SOC SCI HIST
SOCIAL SCIENCE INFORMATION SUR LES SCIENCES SOCIALES = SOC SCI INFORM
SOCIAL SCIENCE JOURNAL = SOC SCI J
SOCIAL SCIENCE QUARTERLY = SOC SCI QUART
SOCIAL SCIENCE RESEARCH = SOC SCI RES
SOCIAL SECURITY BULLETIN = SOC SECUR BULL
SOCIAL SERVICE REVIEW = SOC SERV REV
SOCIAL STUDIES OF SCIENCE = SOC STUD SCI
SOCIAL WORK = SOC WORK
SOCIAL WORK & SOCIAL SCIENCES REVIEW = SOC WORK SOC SCI REV
SOCIAL WORK IN HEALTH CARE = SOC WORK HEALTH CARE
SOCIAL WORK RESEARCH = SOC WORK RES
SOCIAL WORK RESEARCH & ABSTRACTS = SOC WORK RES ABSTR
SOCIALIST REVIEW = SOCIALIST REV
SOCIETY = SOCIETY
SOCIETY & ANIMALS = SOC ANIM
SOCIETY & NATURAL RESOURCES = SOC NATUR RESOUR
SOCIETY OF PETROLEUM ENGINEERS JOURNAL = SOC PETROL ENG J
SOCIO-ECONOMIC PLANNING SCIENCES = SOCIO ECON PLAN SCI
SOCIOBIOLOGY = SOCIOBIOLOGY
SOCIOLOGIA = SOCIOLOGIA
SOCIOLOGIA RURALIS = SOCIOL RURALIS
SOCIOLOGICAL FORUM = SOCIOL FORUM
SOCIOLOGICAL INQUIRY = SOCIOL INQ
SOCIOLOGICAL METHODOLOGY = SOCIOL METHODOL
SOCIOLOGICAL METHODS & RESEARCH = SOCIOL METHOD RES
SOCIOLOGICAL PERSPECTIVES = SOCIOL PERSPECT
SOCIOLOGICAL QUARTERLY = SOCIOL QUART
SOCIOLOGICAL RESEARCH ONLINE = SOCIOL RES ONLINE
SOCIOLOGICAL REVIEW = SOCIOL REV
SOCIOLOGICAL SPECTRUM = SOCIOL SPECTRUM
SOCIOLOGICAL THEORY = SOCIOL THEOR
SOCIOLOGICAL THEORY AND METHODS = SOCIOL THEOR METHOD
SOCIOLOGICKY CASOPIS = SOCIOL CAS
SOCIOLOGIE DU TRAVAIL = SOCIOL TRAV
SOCIOLOGISK FORSKNING = SOCIOL FORSKNIN
SOCIOLOGY OF EDUCATION = SOCIOL EDUC
SOCIOLOGY OF HEALTH & ILLNESS = SOCIOL HEALTH ILL
SOCIOLOGY OF RELIGION = SOCIOL RELIG
SOCIOLOGY OF SPORT JOURNAL = SOCIOL SPORT J
SOCIOLOGY-THE JOURNAL OF THE BRITISH SOCIOLOGICAL ASSOCIATION = SOCIOLOGY
SOFTWARE & MICROSYSTEMS = SOFTW MICROSYST
SOFTWARE & MICROSYSTEMS = SOFTWARE ENG J
SOFTWARE ENGINEERING JOURNAL = SOFTWARE ENG J
SOFTWARE QUALITY JOURNAL = SOFTWARE QUAL J
SOFTWARE REVIEW = SOFTWARE REV
SOFTWARE-CONCEPTS AND TOOLS = SOFTWARE-CONC TOOL
SOFTWARE-PRACTICE & EXPERIENCE = SOFTWARE PRACT EXPER
SOIL & TILLAGE RESEARCH = SOIL TILL RES
SOIL AND CROP SCIENCE SOCIETY OF FLORIDA PROCEEDINGS = SOIL CROP SCI SOC FL
SOIL BIOLOGY & BIOCHEMISTRY = SOIL BIOL BIOCHEM
SOIL DYNAMICS AND EARTHQUAKE ENGINEERING = SOIL DYN EARTHQ ENG
SOIL SCIENCE = SOIL SCI
SOIL SCIENCE AND PLANT NUTRITION = SOIL SCI PLANT NUTR
SOIL SCIENCE SOCIETY OF AMERICA JOURNAL = SOIL SCI SOC AM J
SOIL TECHNOLOGY = SOIL TECHNOL
SOIL USE AND MANAGEMENT = SOIL USE MANAGE
SOLAR AGE = SOL AGE
SOLAR CELLS = SOL CELLS
SOLAR ENERGY = SOL ENERGY
SOLAR ENERGY MATERIALS = SOL ENERG MATER
SOLAR ENERGY MATERIALS AND SOLAR CELLS = SOL ENERG MAT SOL C
SOLAR PHYSICS = SOL PHYS
SOLDERING & SURFACE MOUNT TECHNOLOGY = SOLDER SURF MT TECH
SOLID MECHANICS ARCHIVES = SOLID MECH ARCH
SOLID STATE COMMUNICATIONS = SOLID STATE COMMUN
SOLID STATE IONICS = SOLID STATE IONICS
SOLID STATE NUCLEAR MAGNETIC RESONANCE = SOLID STATE NUCL MAG
SOLID STATE PHENOMENA = SOLID STATE PHENOM
SOLID STATE PHYSICS-ADVANCES IN RESEARCH AND APPLICATIONS = SOLID STATE PHYS
SOLID STATE SCIENCES = SOLID STATE SCI
SOLID STATE TECHNOLOGY = SOLID STATE TECHNOL
SOLID WASTES MANAGEMENT = SOLID WASTE MANAGEM
SOLID-STATE ELECTRONICS = SOLID STATE ELECTRON
SOLVENT EXTRACTION AND ION EXCHANGE = SOLVENT EXTR ION EXC
SOLVENT EXTRACTION RESEARCH AND DEVELOPMENT-JAPAN = SOLVENT EXTR RES DEV
SOMATIC CELL AND MOLECULAR GENETICS = SOMAT CELL MOLEC GEN
SOMATIC CELL GENETICS = SOMAT CELL GENET
SOMATOSENSORY AND MOTOR RESEARCH = SOMATOSENS MOT RES
SOMATOSENSORY RESEARCH = SOMATOSENS MOT RES
SOMATOSENSORY RESEARCH = SOMATOSENS RES
SOTSIOLOGICHESKIE ISSLEDOVANIYA = SOTSIOL ISSLED+
SOUND AND VIBRATION = SOUND VIB
SOUNDINGS = SOUNDINGS
SOURCE-NOTES IN THE HISTORY OF ART = SOURCE-NOTE HIST ART
SOUTH AFRICAN ARCHAEOLOGICAL BULLETIN = S AFR ARCHAEOL BULL
SOUTH AFRICAN JOURNAL OF ANIMAL SCIENCE-SUID-AFRIKAANSE TYDSKRIF VIR VEEKUNDE = S AFR J ANIM SCI
SOUTH AFRICAN JOURNAL OF BOTANY = S AFR J BOT
SOUTH AFRICAN JOURNAL OF BOTANY-SUID-AFRIKAANSE TYDSKRIF VIR PLANTKUNDE = S AFR J BOT
SOUTH AFRICAN JOURNAL OF CHEMISTRY = S AFR J CHEM
SOUTH AFRICAN JOURNAL OF CHEMISTRY-SUID-AFRIKAANSE TYDSKRIF VIR CHEMIE = S AFR J CHEM-S-AFR T
SOUTH AFRICAN JOURNAL OF ECONOMICS = S AFR J ECON
SOUTH AFRICAN JOURNAL OF GEOLOGY = S AFR J GEOL
SOUTH AFRICAN JOURNAL OF MARINE SCIENCE-SUID-AFRIKAANSE TYDSKRIF VIR SEEWETENSKAP = S AFR J MARINE SCI
SOUTH AFRICAN JOURNAL OF PHILOSOPHY-SUID-AFRIKAANSE TYDSKRIF VIR WYSBEGEERTE = S AFR J PHILOS
SOUTH AFRICAN JOURNAL OF PHYSICS - SUID-AFRIKAANSE TYDSKRIF VIR FISIKA = S AFR J PHYS
SOUTH AFRICAN JOURNAL OF PSYCHOLOGY = S AFR J PSYCHOL
SOUTH AFRICAN JOURNAL OF PSYCHOLOGY-SUID-AFRIKAANSE TYDSKRIF VIR SIELKUNDE = S AFR J PSYCHOL
SOUTH AFRICAN JOURNAL OF SCIENCE = S AFR J SCI
SOUTH AFRICAN JOURNAL OF SURGERY = S AFR J SURG
SOUTH AFRICAN JOURNAL OF WILDLIFE RESEARCH = S AFR J WILDL RES
SOUTH AFRICAN JOURNAL OF ZOOLOGY = S AFR J ZOOL
SOUTH AFRICAN JOURNAL OF ZOOLOGY-SUID-AFRIKAANSE TYDSKRIF VIR DIERKUNDE = S AFR J ZOOL
SOUTH AFRICAN MECHANICAL ENGINEER = S AFR MECH ENG
SOUTH AFRICAN MEDICAL JOURNAL = S AFR MED J
SOUTH AFRICAN STATISTICAL JOURNAL = S AFR STAT J
SOUTH ASIA-JOURNAL OF SOUTH ASIAN STUDIES = S ASIA
SOUTH ATLANTIC QUARTERLY = S ATL QUART
SOUTH DAKOTA FARM & HOME RESEARCH = S DAK FARM HOME RES
SOUTH DAKOTA REVIEW = S DAK REV
SOUTHERLY = SOUTHERLY
SOUTHERN CALIFORNIA LAW REVIEW = SOUTHERN CALIF LAW R
SOUTHERN CULTURES = SOUTH CULT
SOUTHERN ECONOMIC JOURNAL = SOUTHERN ECON J
SOUTHERN HUMANITIES REVIEW = SOUTHERN HUMAN REV
SOUTHERN JOURNAL OF PHILOSOPHY = SOUTHERN J PHILOS
SOUTHERN LITERARY JOURNAL = SOUTHERN LIT J
SOUTHERN MEDICAL JOURNAL = SOUTHERN MED J
SOUTHWESTERN ENTOMOLOGIST = SOUTHWEST ENTOMOL
SOUTHWESTERN HISTORICAL QUARTERLY = SOUTHWEST HIST QUART
SOUTHWESTERN NATURALIST = SOUTHWEST NAT
SOUTHWESTERN VETERINARIAN = SOUTHWEST VET
SOVETSKAYA MEDITSINA = SOV MEDITISINA
SOVIET APPLIED MECHANICS = SOV APPL MECH+
SOVIET ASTRONOMY LETTERS = SOV ASTRON LETT+
SOVIET ATOMIC ENERGY = SOV ATOM ENERGY+
SOVIET ELECTROCHEMISTRY = SOV ELECTROCHEM+
SOVIET ENGINEERING RESEARCH = SOV ENG RES
SOVIET JOURNAL OF COMPUTER AND SYSTEMS SCIENCES = SOV J COMPUT SYST S+
SOVIET JOURNAL OF ECOLOGY = SOV J ECOL+
SOVIET JOURNAL OF NONDESTRUCTIVE TESTING-USSR = SOV J NONDESTR TEST+
SOVIET JOURNAL OF NUCLEAR PHYSICS-USSR = SOV J NUCL PHYS+
SOVIET JOURNAL OF NUMERICAL ANALYSIS AND MATHEMATICAL MODELLING = SOV J NUMER ANAL MAT
SOVIET JOURNAL OF OPTICAL TECHNOLOGY = SOV J OPT TECHNOL+
SOVIET JOURNAL OF REMOTE SENSING = SOV J REMOT SENS+
SOVIET MATERIALS SCIENCE = SOV MATER SCI+
SOVIET MICROELECTRONICS = SOV MICROELECTRON+
SOVIET MINING SCIENCE USSR = SOV MIN SCI+
SOVIET PHYSICS ACOUSTICS-USSR = SOV PHYS ACOUST+
SOVIET PHYSICS SEMICONDUCTORS-USSR = SOV PHYS SEMICOND+
SOVIET PLANT PHYSIOLOGY = SOV PLANT PHYSIOL+
SOVIET POWDER METALLURGY AND METAL CERAMICS = SOV POWDER METALL+
SOVIET RADIOCHEMISTRY = SOV RADIOCHEM+
SOVIET SOIL SCIENCE = SOV SOIL SCI+
SOZIAL-UND PRAVENTIVMEDIZIN = SOZ PRAVENTIV MED
SOZIALE WELT-ZEITSCHRIFT FUR SOZIALWISSENSCHAFTLICHE FORSCHUNG UND PRAXIS = SOZ WELT
SPACE COMMUNICATIONS = SPACE COMMUN
SPACE POLICY = SPACE POLICY
SPACE POWER = SPACE POWER
SPACE SCIENCE REVIEWS = SPACE SCI REV
SPACE SOLAR POWER REVIEW = SPACE POWER
SPACE TECHNOLOGY-INDUSTRIAL AND COMMERCIAL APPLICATIONS = SPACE TECHNOL
SPAN = SPAN
SPATIAL VISION = SPATIAL VISION
SPAZIO E SOCIETA-SPACE & SOCIETY = SPAZ SOC-SPACE SOC
SPE DRILLING & COMPLETION = SPE DRILL COMPLETION
SPE FORMATION EVALUATION = SPE FORMATION EVAL
SPE PRODUCTION & FACILITIES = SPE PROD FACIL
SPE RESERVOIR ENGINEERING = SPE RESERVOIR ENG
SPE RESERVOIR EVALUATION & ENGINEERING = SPE RESERV EVAL ENG
SPECIAL LIBRARIES = SPEC LIBR
SPECIAL PAPERS IN PALAEONTOLOGY = SPEC PAP PALAEONTOL
SPECIFYING ENGINEER = SPECIF ENG
SPECTROCHIMICA ACTA PART A-MOLECULAR AND BIOMOLECULAR SPECTROSCOPY = SPECTROCHIM ACTA A
SPECTROCHIMICA ACTA PART B-ATOMIC SPECTROSCOPY = SPECTROCHIM ACTA B
SPECTROCHIMICA ACTA REVIEWS = SPECTROCHIM ACTA REV
SPECTROSCOPY = SPECTROSCOPY
SPECTROSCOPY AND SPECTRAL ANALYSIS = SPECTROSC SPECT ANAL
SPECTROSCOPY LETTERS = SPECTROSC LETT
SPECTROSCOPY-AN INTERNATIONAL JOURNAL = SPECTROSC-INT J
SPECTRUM-THE JOURNAL OF STATE GOVERNMENT = SPECTRUM-J STATE GOV
SPECULATIONS IN SCIENCE AND TECHNOLOGY = SPECULAT SCI TECHNOL
SPECULUM-A JOURNAL OF MEDIEVAL STUDIES = SPECULUM
SPEECH COMMUNICATION = SPEECH COMMUN
SPIEGEL DER LETTEREN = SPIEGEL LETT
SPILL SCIENCE & TECHNOLOGY BULLETIN = SPILL SCI TECHNOL B
SPINAL CORD = SPINAL CORD
SPINE = SPINE
SPORT EDUCATION AND SOCIETY = SPORT EDUC SOC
SPORT PSYCHOLOGIST = SPORT PSYCHOL
SPORT SCIENCE REVIEW = SPORT SCI REV
SPORTS EXERCISE AND INJURY = SPORTS EXERC INJURY
SPORTS MEDICINE = SPORTS MED
SPORTS MEDICINE AND ARTHROSCOPY REVIEW = SPORTS MED ARTHROSC
SPORTS MEDICINE STANDARDS AND MALPRACTICE REPORTER = SPORTS MED STAND MAL
SPORTVERLETZUNG-SPORTSCHADEN = SPORTVERLETZ SPORTSC
SPRACHE & KOGNITION = SPRACHE KOGNIT
SPRACHWISSENSCHAFT = SPRACHWISSENSCHAFT
SPRINGER SEMINARS IN IMMUNOPATHOLOGY = SPRINGER SEMIN IMMUN
SPRINGER TRACTS IN MODERN PHYSICS = SPRINGER TR MOD PHYS
SRA-JOURNAL OF THE SOCIETY OF RESEARCH ADMINISTRATORS = SRA-J SOC RES ADMIN
STAHL UND EISEN = STAHL EISEN
STAIN TECHNOLOGY = STAIN TECHNOL
STAND MAGAZINE = STAND MAG
STANFORD FRENCH REVIEW = STANFORD FR REV
STANFORD JOURNAL OF INTERNATIONAL LAW = STANFORD J INT LAW
STANFORD LAW REVIEW = STANFORD LAW REV
STARCH-STARKE = STARCH-STARKE
STARKE = STARCH-STARKE
STARKE = STARKE
STATISTICA NEERLANDICA = STAT NEERL
STATISTICA SINICA = STAT SINICA
STATISTICAL METHODS IN MEDICAL RESEARCH = STAT METHODS MED RES
STATISTICAL PAPERS = STAT PAP
STATISTICAL SCIENCE = STAT SCI
STATISTICIAN = STATISTICIAN
STATISTICS = STATISTICS
STATISTICS & PROBABILITY LETTERS = STAT PROBABIL LETT
STATISTICS AND COMPUTING = STAT COMPUT
STATISTICS IN MEDICINE = STAT MED
STAUB REINHALTUNG DER LUFT = STAUB REINHALT LUFT
STEEL IN THE USSR = STEEL TRANSL
STEEL IN THE USSR = STEEL USSR
STEEL IN TRANSLATION = STEEL TRANSL
STEEL RESEARCH = STEEL RES
STEINBECK QUARTERLY = STEINBECK QUART
STEM CELLS = STEM CELLS
STEREOTACTIC AND FUNCTIONAL NEUROSURGERY = STEREOT FUNCT NEUROS
STEROIDS = STEROIDS
STOCHASTIC ANALYSIS AND APPLICATIONS = STOCH ANAL APPL
STOCHASTIC ENVIRONMENTAL RESEARCH AND RISK ASSESSMENT = STOCH ENV RES RISK A
STOCHASTIC HYDROLOGY AND HYDRAULICS = STOCH HYDROL HYDRAUL
STOCHASTIC PROCESSES AND THEIR APPLICATIONS = STOCH PROC APPL
STORIA CONTEMPORANEA = STORIA CONTEMP
STORIA DELL ARTE = STORIA ARTE
STP PHARMA SCIENCES = STP PHARMA SCI
STRAD = STRAD
STRAHLENTHERAPIE = STRAHLENTHER ONKOL
STRAHLENTHERAPIE UND ONKOLOGIE = STRAHLENTHER ONKOL
STRATEGIC MANAGEMENT JOURNAL = STRATEGIC MANAGE J
STRATIGRAPHY AND GEOLOGICAL CORRELATION = STRATIGR GEO CORREL+
STRATIGRAPHY AND GEOLOGICAL CORRELATION = STRATIGR GEOL CORREL
STRENGTH AND CONDITIONING = STRENGTH COND
STRENGTH AND CONDITIONING JOURNAL = STRENGTH COND J
STRENGTH OF MATERIALS = STRENGTH MATER+
STRESS MEDICINE = STRESS MEDICINE
STROJARSTVO = STROJARSTVO
STROJNISKI VESTNIK-JOURNAL OF MECHANICAL ENGINEERING = STROJ VESTN-J MECH E
STROKE = STROKE
STRUCTURAL AND ELECTRONIC PARADIGMS IN CLUSTER CHEMISTRY = STRUCT BOND
STRUCTURAL AND MULTIDISCIPLINARY OPTIMIZATION = STRUCT MULTIDISCIP O
STRUCTURAL CHEMISTRY = STRUCT CHEM
STRUCTURAL DESIGN OF TALL BUILDINGS = STRUCT DES TALL BUIL
STRUCTURAL ENGINEER-PART A = STRUCT ENG-A
STRUCTURAL ENGINEER-PART B = STRUCT ENG-B
STRUCTURAL ENGINEERING AND MECHANICS = STRUCT ENG MECH
STRUCTURAL ENGINEERING PRACTICE = STRUCT ENG PRACT
STRUCTURAL ENGINEERING REVIEW = STRUCT ENG REV
STRUCTURAL OPTIMIZATION = STRUCT OPTIMIZATION
STRUCTURAL SAFETY = STRUCT SAF
STRUCTURE = STRUCTURE
STRUCTURE AND BONDING = STRUCT BOND
STRUCTURE WITH FOLDING & DESIGN = STRUCT FOLD DES
STRUCTURED PROGRAMMING = STRUCT PROGRAM
STUDI E PROBLEMI DI CRITICA TESTUALE = STUD PROBL CRIT TEST
STUDI FRANCESI = STUD FRANCESI
STUDI MEDIEVALI = STUD MEDIEV
STUDI MUSICALI = STUD MUSIC
STUDI PIEMONTESI = STUD PIEMONTESI
STUDI ROMANI = STUD ROMANI
STUDI SECENTESCHI = STUD SECENTESCHI
STUDI STORICI = STUD STORICI
STUDIA BIOPHYSICA = STUD BIOPHYS
STUDIA GEOPHYSICA ET GEODAETICA = STUD GEOPHYS GEOD
STUDIA LEIBNITIANA = STUD LEIBNITIANA
STUDIA LINGUISTICA = STUD LINGUISTICA
STUDIA MATHEMATICA = STUD MATH
STUDIA MONASTICA = STUD MONASTICA
STUDIA MYSTICA = STUD MYST
STUDIA NEOPHILOLOGICA = STUD NEOPHILOL
STUDIA PSYCHOLOGICA = STUD PSYCHOL
STUDIA ROSENTHALIANA = STUD ROSENTHALIANA
STUDIA SCIENTIARUM MATHEMATICARUM HUNGARICA = STUD SCI MATH HUNG
STUDIES IN AMERICAN FICTION = STUD AM FICTION
STUDIES IN AMERICAN POLITICAL DEVELOPMENT = STUD AM POLIT DEV
STUDIES IN APPLIED MATHEMATICS = STUD APPL MATH
STUDIES IN CANADIAN LITERATURE-ETUDES EN LITTERATURE CANADIENNE = STUD CAN LIT
STUDIES IN COMPARATIVE INTERNATIONAL DEVELOPMENT = STUD COMP INT DEV
STUDIES IN CONSERVATION = STUD CONSERV
STUDIES IN EAST EUROPEAN THOUGHT = STUD E EUR THOUGHT
STUDIES IN EIGHTEENTH-CENTURY CULTURE = STUD EIGHTEENTH-CENT
STUDIES IN ENGLISH LITERATURE 1500-1900 = STUD ENGL LIT-1500
STUDIES IN FAMILY PLANNING = STUD FAMILY PLANN
STUDIES IN HIGHER EDUCATION = STUD HIGH EDUC
STUDIES IN HISTORY AND PHILOSOPHY OF MODERN PHYSICS = STUD HIST PHILOS M P
STUDIES IN HISTORY AND PHILOSOPHY OF SCIENCE = STUD HIST PHILOS SCI
STUDIES IN LANGUAGE = STUD LANG
STUDIES IN LATIN AMERICAN POPULAR CULTURE = STUD LAT AM POP CULT
STUDIES IN MYCOLOGY = STUD MYCOL
STUDIES IN NONLINEAR DYNAMICS AND ECONOMETRICS = STUD NONLINEAR DYN E
STUDIES IN PHILOLOGY = STUD PHILOL
STUDIES IN RELIGION-SCIENCES RELIGIEUSES = STUD RELIG-SCI RELIG
STUDIES IN ROMANTICISM = STUD ROMANTICISM
STUDIES IN SHORT FICTION = STUD SHORT FICTION
STUDIES IN SURFACE SCIENCE AND CATALYSIS = STUD SURF SCI CATAL
STUDIES IN SYMBOLIC INTERACTION = STUD SYM IN
STUDIES IN SYMBOLIC INTERACTION = STUD SYMB INTERACT
STUDIES IN THE HISTORY OF ART = STUD HIST ART
STUDIES IN THE HISTORY OF GARDENS & DESIGNED LANDSCAPES = STUD HIST GARD DES L
STUDIES IN THE LITERARY IMAGINATION = STUD LIT IMAGINATION
STUDIES IN THE NOVEL = STUD NOVEL
STUDIES ON NEOTROPICAL FAUNA AND ENVIRONMENT = STUD NEOTROP FAUNA E
STYGOLOGIA = STYGOLOGIA
STYLE = STYLE
SUB-STANCE = SUB-STANCE
SUBSTANCE USE & MISUSE = SUBST USE MISUSE
SUGAR JOURNAL = SUGAR J
SUGAR TECHNOLOGY REVIEWS = SUGAR TECHNOL REV
SUGAR Y AZUCAR = SUGAR AZUCAR
SUGARCANE PATHOLOGISTS NEWSLETTER = SUGARCANE PATHOL NEW
SUICIDE AND LIFE-THREATENING BEHAVIOR = SUICIDE LIFE-THREAT
SUID-AFRIKAANSE HISTORIESE JOERNAAL-SOUTH AFRICAN HISTORICAL JOURNAL = S AFR HIST J
SUMITOMO LIGHT METAL TECHNICAL REPORTS = SUMITOMO LIGHT M TEC
SUPERCOMPUTER = SUPERCOMPUTER
SUPERCONDUCTOR SCIENCE & TECHNOLOGY = SUPERCOND SCI TECH
SUPERLATTICES AND MICROSTRUCTURES = SUPERLATTICE MICROST
SUPPORTIVE CARE IN CANCER = SUPPORT CARE CANCER
SUPRAMOLECULAR CHEMISTRY = SUPRAMOL CHEM
SUPRAMOLECULAR SCIENCE = SUPRAMOL SCI
SUPREME COURT REVIEW = SUPREME COURT REV
SURFACE & COATINGS TECHNOLOGY = SURF COAT TECH
SURFACE AND INTERFACE ANALYSIS = SURF INTERFACE ANAL
SURFACE ENGINEERING = SURFACE ENG
SURFACE REVIEW AND LETTERS = SURF REV LETT
SURFACE SCIENCE = SURF SCI
SURFACE SCIENCE REPORTS = SURF SCI REP
SURFACE TECHNOLOGY = SURF TECHNOL
SURGERY = SURGERY
SURGERY GYNECOLOGY & OBSTETRICS = SURG GYNECOL OBSTET
SURGERY TODAY-THE JAPANESE JOURNAL OF SURGERY = SURG TODAY
SURGICAL AND RADIOLOGIC ANATOMY = SURG RADIOL ANAT
SURGICAL CLINICS OF NORTH AMERICA = SURG CLIN N AM
SURGICAL ENDOSCOPY-ULTRASOUND AND INTERVENTIONAL TECHNIQUES = SURG ENDOSC-ULTRAS
SURGICAL FORUM = SURG FORUM
SURGICAL LAPAROSCOPY & ENDOSCOPY = SURG LAPAROSC ENDOSC
SURGICAL LAPAROSCOPY ENDOSCOPY & PERCUTANEOUS TECHNIQUES = SURG LAPARO ENDO PER
SURGICAL NEUROLOGY = SURG NEUROL
SURGICAL ONCOLOGY-OXFORD = SURG ONCOL
SURVEY AND SYNTHESIS OF PATHOLOGY RESEARCH = SURV SYN PATHOL RES
SURVEY OF IMMUNOLOGIC RESEARCH = SURV IMMUNOL RES
SURVEY OF OPHTHALMOLOGY = SURV OPHTHALMOL
SURVEY REVIEW = SURV REV
SURVEYING AND MAPPING = SURV MAPP
SURVEYS IN GEOPHYSICS = SURV GEOPHYS
SURVIVAL = SURVIVAL
SUSTAINABLE DEVELOPMENT = SUSTAIN DEV
SVENSK PAPPERSTIDNING-NORDISK CELLULOSA = SVEN PAPPERSTIDN
SVENSK TIDSKRIFT FOR MUSIKFORSKNING = SVEN TIDSKR MUSIKFOR
SWEDISH DENTAL JOURNAL = SWED DENT J
SWEDISH JOURNAL OF AGRICULTURAL RESEARCH = SWED J AGR RES
SWINE HEALTH AND PRODUCTION = SWINE HEALTH PROD
SWISS JOURNAL OF PSYCHOLOGY = SWISS J PSYCHOL
SYDOWIA = SYDOWIA
SYESIS = SYESIS
SYMBIOSIS = SYMBIOSIS
SYMBOLIC INTERACTION = SYMB INTERACT
SYMPOSIA OF THE SOCIETY FOR EXPERIMENTAL BIOLOGY = SYM SOC EXP BIOL
SYMPOSIUM-A QUARTERLY JOURNAL IN MODERN FOREIGN LITERATURES = SYMPOSIUM
SYMPOSIUM-A QUARTERLY JOURNAL IN MODERN LITERATURES = SYMPOSIUM
SYNAPSE = SYNAPSE
SYNERGISTIC USE OF MULTISENSOR DATA FOR LAND PROCESSES = ADV SPACE RES
SYNLETT = SYNLETT
SYNTAX AND SEMANTICS = SYNTAX SEMANTICS
SYNTHESE = SYNTHESE
SYNTHESIS AND REACTIVITY IN INORGANIC AND METAL-ORGANIC CHEMISTRY = SYN REACT INORG MET
SYNTHESIS-CAMBRIDGE = SYNTHESIS-CAMBRIDGE
SYNTHESIS-STUTTGART = SYNTHESIS-STUTTGART
SYNTHETIC COMMUNICATIONS = SYNTHETIC COMMUN
SYNTHETIC METALS = SYNTHETIC MET
SYSTEM DYNAMICS REVIEW = SYST DYNAM REV
SYSTEM FAMILIE = SYST FAM
SYSTEM FAMILIE-FORSCHUNG UND THERAPIE = SYST FAM
SYSTEMATIC AND APPLIED MICROBIOLOGY = SYST APPL MICROBIOL
SYSTEMATIC BIOLOGY = SYST BIOL
SYSTEMATIC BOTANY = SYST BOT
SYSTEMATIC ENTOMOLOGY = SYST ENTOMOL
SYSTEMATIC PARASITOLOGY = SYST PARASITOL
SYSTEMATIC ZOOLOGY = SYST ZOOL
SYSTEMIC PRACTICE AND ACTION RESEARCH = SYST PRACT ACT RES
SYSTEMS & CONTROL LETTERS = SYST CONTROL LETT
SYSTEMS ANALYSIS MODELLING SIMULATION = SYST ANAL MODEL SIM
SYSTEMS AND COMPUTERS IN JAPAN = SYST COMPUT JPN
SYSTEMS INTEGRATION BUSINESS = SYST INTEGRAT BUS
SYSTEMS OBJECTIVES SOLUTIONS = SYST OBJECT SOLUT
SYSTEMS PRACTICE = SYST PRACTICE
SYSTEMS RESEARCH = SYST RES
SYSTEMS RESEARCH AND BEHAVIORAL SCIENCE = SYST RES BEHAV SCI
SYSTEMS RESEARCH AND INFORMATION SCIENCE = SYST RES INFORM SCI
