TAIWANESE JOURNAL OF MATHEMATICS = TAIWAN J MATH
TALANTA = TALANTA
TAPPI = TAPPI
TAPPI JOURNAL = TAPPI J
TAXON = TAXON
TCI = TCI
TDR-THE DRAMA REVIEW-A JOURNAL OF PERFORMANCE STUDIES = TDR-DRAMA REV-J PERF
TEACHERS COLLEGE RECORD = TEACH COLL REC
TEACHING AND LEARNING IN MEDICINE = TEACH LEARN MED
TEACHING AND TEACHER EDUCATION = TEACH TEACH EDUC
TEACHING OF PSYCHOLOGY = TEACH PSYCHOL
TEACHING SOCIOLOGY = TEACH SOCIOL
TECHNICAL COMMUNICATION = TECH COMMUN
TECHNICAL PHYSICS = TECH PHYS+
TECHNICAL PHYSICS LETTERS = TECH PHYS LETT+
TECHNIQUE ET SCIENCE INFORMATIQUES = TECH SCI INFORM
TECHNIQUES IN NEUROSURGERY = TECH NEUROSURG
TECHNISCHE MITTEILUNGEN KRUPP FORSCHUNGSBERICHTE = TECH MITT KRUPP FORS
TECHNISCHES MESSEN = TECH MESS
TECHNOLOGICAL FORECASTING AND SOCIAL CHANGE = TECHNOL FORECAST SOC
TECHNOLOGY ANALYSIS & STRATEGIC MANAGEMENT = TECHNOL ANAL STRATEG
TECHNOLOGY AND CULTURE = TECHNOL CULT
TECHNOLOGY AND DISABILITY = TECHNOL DISABIL
TECHNOLOGY AND HEALTH CARE = TECHNOL HEALTH CARE
TECHNOLOGY IN SOCIETY = TECHNOL SOC
TECHNOLOGY REVIEW = TECHNOL REV
TECHNOLOGY TRANSFER AND TRAINING = TRANSPORT RES REC
TECHNOMETRICS = TECHNOMETRICS
TECHNOVATION = TECHNOVATION
TECTONICS = TECTONICS
TECTONOPHYSICS = TECTONOPHYSICS
TEKSTIL = TEKSTIL
TELE-ENGLISH EDITION = TELE-ENGL EDITION
TELECOMMUNICATION JOURNAL = TELECOMMUN J
TELECOMMUNICATION SYSTEMS = TELECOMMUN SYST
TELECOMMUNICATIONS AND RADIO ENGINEERING = TELECOMM RADIO ENG+
TELECOMMUNICATIONS POLICY = TELECOMMUN POLICY
TELEMEDICINE JOURNAL = TELEMED J
TELEPHONY = TELEPHONY
TELETEACHING = IFIP TRANS A
TELEVISION QUARTERLY = TELEV QUART
TELLUS = TELLUS
TELLUS SERIES A-DYNAMIC METEOROLOGY AND OCEANOGRAPHY = TELLUS A
TELLUS SERIES B-CHEMICAL AND PHYSICAL METEOROLOGY = TELLUS B
TEMENOS = TEMENOS
TEMPLE LAW REVIEW = TEMPLE LAW REV
TEMPO = TEMPO
TEMPS MODERNES = TEMPS MODERNES
TENNESSEE AGRICULTURAL EXPERIMENT STATION BULLETIN = TENN AES BULL
TENNESSEE FARM & HOME SCIENCE = TENN FARM HOME SCI
TENSIDE SURFACTANTS DETERGENTS = TENSIDE SURFACT DET
TEORETICHESKAYA I EKSPERIMENTALNAYA KHIMIYA = TEOR EKSP KHIM
TERAPEVTICHESKII ARKHIV = TERAPEVT ARKH
TERATOGENESIS CARCINOGENESIS AND MUTAGENESIS = TERATOGEN CARCIN MUT
TERATOLOGY = TERATOLOGY
TERRA NOVA = TERRA NOVA
TERRE ET LA VIE-REVUE D ECOLOGIE APPLIQUEE = TERRE VIE-REV ECOL A
TERRESTRIAL ATMOSPHERIC AND OCEANIC SCIENCES = TERR ATMOS OCEAN SCI
TESOL QUARTERLY = TESOL QUART
TEST = TEST
TESTING OF CONVENTIONAL AND UNCONVENTIONAL AGGREGATES AND SOILS = TRANSPORT RES REC
TETHYS = TETHYS
TETRAHEDRON = TETRAHEDRON
TETRAHEDRON LETTERS = TETRAHEDRON LETT
TETRAHEDRON-ASYMMETRY = TETRAHEDRON-ASYMMETR
TETSU TO HAGANE-JOURNAL OF THE IRON AND STEEL INSTITUTE OF JAPAN = TETSU TO HAGANE
TEXAS AGRICULTURAL EXPERIMENT STATION BULLETIN = TEX AES BULL
TEXAS AGRICULTURAL EXPERIMENT STATION MISCELLANEOUS PUBLICATION = TEX AES MISC PUBL
TEXAS AGRICULTURAL EXPERIMENT STATION PROGRESS REPORT = TEX AES PROG REP
TEXAS HEART INSTITUTE JOURNAL = TEX HEART I J
TEXAS JOURNAL OF SCIENCE = TEX J SCI
TEXAS LAW REVIEW = TEX LAW REV
TEXAS MEDICINE = TEX MED
TEXAS REPORTS ON BIOLOGY AND MEDICINE = TEX REP BIOL MED
TEXAS STUDIES IN LITERATURE AND LANGUAGE = TEX STUD LIT LANG
TEXT & KRITIK = TEXT KRITIK
TEXTE-REVUE DE CRITIQUE ET DE THEORIE LITTERAIRE = TEXTE
TEXTILE CHEMIST AND COLORIST = TEXT CHEM COLOR
TEXTILE CHEMIST AND COLORIST & AMERICAN DYESTUFF REPORTER = TEXT CHEM COLOR AM D
TEXTILE INDUSTRIES = TEXT IND-ATLANTA
TEXTILE RESEARCH JOURNAL = TEXT RES J
TEXTILE WORLD = TEXT WORLD
TEXTILVEREDLUNG = TEXTILVEREDLUNG
TEXTUAL PRACTICE = TEXTUAL PRACT
TEXTURES AND MICROSTRUCTURES = TEXTURE MICROSTRUCT
TGO-TIJDSCHRIFT VOOR GENEESMIDDELENONDERZOEK-JOURNAL OF DRUG RESEARCH-JDR = TGO-TIJDSCHR THER GE
TGO-TIJDSCHRIFT VOOR THERAPIE GENEESMIDDEL EN ONDERZOEK JDR-JOURNAL FOR DRUGTHERAPY AND RESEARCH = TGO-TIJDSCHR THER GE
THALIA-STUDIES IN LITERARY HUMOR = THALIA
THEATER = THEATER
THEATER HEUTE = THEATER HEUTE
THEATRE HISTORY STUDIES = THEATRE HIST STUD
THEATRE JOURNAL = THEATRE J
THEATRE NOTEBOOK = THEATRE NOTEBOOK
THEATRE RESEARCH IN CANADA-RECHERCHES THEATRALES AU CANADA = THEATRE RES CANADA
THEATRE RESEARCH INTERNATIONAL = THEATRE RES INT
THEATRE STUDIES = THEATRE STUD
THEATRE SURVEY = THEATRE SURVEY
THEOCHEM-JOURNAL OF MOLECULAR STRUCTURE = THEOCHEM-J MOL STRUC
THEOLOGICAL STUDIES = THEOL STUD
THEOLOGY TODAY = THEOL TODAY
THEORETICA CHIMICA ACTA = THEOR CHIM ACTA
THEORETICAL AND APPLIED CLIMATOLOGY = THEOR APPL CLIMATOL
THEORETICAL AND APPLIED FRACTURE MECHANICS = THEOR APPL FRACT MEC
THEORETICAL AND APPLIED GENETICS = THEOR APPL GENET
THEORETICAL AND COMPUTATIONAL FLUID DYNAMICS = THEOR COMP FLUID DYN
THEORETICAL AND MATHEMATICAL PHYSICS = THEOR MATH PHYS+
THEORETICAL CHEMISTRY ACCOUNTS = THEOR CHEM ACC
THEORETICAL COMPUTER SCIENCE = THEOR COMPUT SCI
THEORETICAL FOUNDATIONS OF CHEMICAL ENGINEERING = THEOR FOUND CHEM ENG
THEORETICAL LINGUISTICS = THEOR LINGUIST
THEORETICAL MEDICINE = THEOR MED
THEORETICAL MEDICINE AND BIOETHICS = THEOR MED BIOETH
THEORETICAL POPULATION BIOLOGY = THEOR POPUL BIOL
THEORETICAL SURGERY = THEOR SURG
THEORY & PSYCHOLOGY = THEOR PSYCHOL
THEORY AND DECISION = THEOR DECIS
THEORY AND PRACTICE OF OBJECT SYSTEMS = THEOR PRACT OBJ SYST
THEORY AND RESEARCH IN SOCIAL EDUCATION = THEOR RES SOC EDUC
THEORY AND SOCIETY = THEOR SOC
THEORY CULTURE & SOCIETY = THEOR CULT SOC
THEORY IN BIOSCIENCES = THEOR BIOSCI
THEORY INTO PRACTICE = THEOR PRACT
THEORY OF COMPUTING SYSTEMS = THEOR COMPUT SYST
THEORY OF PROBABILITY AND ITS APPLICATIONS = THEOR PROBAB APPL+
THERAPEUTIC DRUG MONITORING = THER DRUG MONIT
THERAPEUTISCHE UMSCHAU = THER UMSCH
THERAPIE = THERAPIE
THERIOGENOLOGY = THERIOGENOLOGY
THERMAL ENGINEERING = THERM ENG+
THERMOCHIMICA ACTA = THERMOCHIM ACTA
THIN SOLID FILMS = THIN SOLID FILMS
THIN-WALLED STRUCTURES = THIN WALL STRUCT
THIRD WORLD PLANNING REVIEW = THIRD WORLD PLAN REV
THIRD WORLD QUARTERLY = THIRD WORLD Q
THOMAS WOLFE REVIEW = THOMAS WOLFE REV
THOMIST = THOMIST
THORACIC AND CARDIOVASCULAR SURGEON = THORAC CARDIOV SURG
THORAX = THORAX
THROMBOSIS AND HAEMOSTASIS = THROMB HAEMOSTASIS
THROMBOSIS RESEARCH = THROMB RES
THYMUS = THYMUS
THYROID = THYROID
TIDSSKRIFT FOR SAMFUNNSFORSKNING = TIDSSKR SAMFUNNSFOR
TIERARZTLICHE PRAXIS = TIERARZTL PRAX
TIERARZTLICHE PRAXIS AUSGABE GROBTIERE NUTZTIERE = TIERARZTL PRAX G N
TIERARZTLICHE PRAXIS AUSGABE KLEINTIERE HEIMTIERE = TIERARZTL PRAX K H
TIERARZTLICHE UMSCHAU = TIERARZTL UMSCHAU
TIJDSCHRIFT VAN DE KONINKLIJKE VERENIGING VOOR NEDERLANDSE MUZIEKGESCHIEDENIS = TIJD K VER NED MUZ
TIJDSCHRIFT VAN DE VERENIGING VOOR NEDERLANDSE MUZIEKGESCHIEDENIS = TIJDSCHR VER NED MUZ
TIJDSCHRIFT VOOR DIERGENEESKUNDE = TIJDSCHR DIERGENEESK
TIJDSCHRIFT VOOR ECONOMISCHE EN SOCIALE GEOGRAFIE = TIJDSCHR ECON SOC GE
TIJDSCHRIFT VOOR FILOSOFIE = TIJDSCHR FILOS
TIJDSCHRIFT VOOR GESCHIEDENIS = TIJDSCHR GESCHIEDEN
TIJDSCHRIFT VOOR NEDERLANDSE TAAL-EN LETTERKUNDE = TIJDSCHR NED TAAL L
TIKHOOKEANSKAYA GEOLOGIYA = TIKHOOKEAN GEOL
TIME & SOCIETY = TIME SOC
TISSUE & CELL = TISSUE CELL
TISSUE ANTIGENS = TISSUE ANTIGENS
TISSUE ENGINEERING = TISSUE ENG
TLS-THE TIMES LITERARY SUPPLEMENT = TLS-TIMES LIT SUPPL
TOBACCO CONTROL = TOB CONTROL
TOHOKU JOURNAL OF EXPERIMENTAL MEDICINE = TOHOKU J EXP MED
TOHOKU MATHEMATICAL JOURNAL = TOHOKU MATH J
TOOLING & PRODUCTION = TOOL PROD
TOPICS IN APPLIED PHYSICS = TOP APPL PHYS
TOPICS IN CATALYSIS = TOP CATAL
TOPICS IN CURRENT CHEMISTRY = TOP CURR CHEM
TOPICS IN EARLY CHILDHOOD SPECIAL EDUCATION = TOP EARLY CHILD SPEC
TOPICS IN GERIATRIC REHABILITATION = TOP GERIATR REHABIL
TOPICS IN LANGUAGE DISORDERS = TOP LANG DISORD
TOPICS IN MAGNETIC RESONANCE IMAGING = TOP MAGN RESON IMAG
TOPICS IN STEREOCHEMISTRY = TOP STEREOCHEM
TOPOI-AN INTERNATIONAL REVIEW OF PHILOSOPHY = TOPOI-INT REV PHILOS
TOPOLOGY = TOPOLOGY
TOPOLOGY AND ITS APPLICATIONS = TOPOL APPL
TOSHIBA REVIEW = TOSHIBA REV
TOTAL QUALITY MANAGEMENT = TOTAL QUAL MANAGE
TOUNG PAO = TOUNG PAO
TOURISM MANAGEMENT = TOURISM MANAGE
TOXIC SUBSTANCE MECHANISMS = TOX SUBST MECH
TOXICITY ASSESSMENT = TOXIC ASSESS
TOXICOLOGIC PATHOLOGY = TOXICOL PATHOL
TOXICOLOGICAL AND ENVIRONMENTAL CHEMISTRY = TOXICOL ENVIRON CHEM
TOXICOLOGICAL SCIENCES = TOXICOL SCI
TOXICOLOGY = TOXICOLOGY
TOXICOLOGY AND APPLIED PHARMACOLOGY = TOXICOL APPL PHARM
TOXICOLOGY AND INDUSTRIAL HEALTH = TOXICOL IND HEALTH
TOXICOLOGY IN VITRO = TOXICOL IN VITRO
TOXICOLOGY LETTERS = TOXICOL LETT
TOXICOLOGY METHODS = TOXICOL METHOD
TOXICON = TOXICON
TRAC-TRENDS IN ANALYTICAL CHEMISTRY = TRAC-TREND ANAL CHEM
TRACE ELEMENTS AND ELECTROLYTES = TRACE ELEM ELECTROLY
TRACE ELEMENTS IN MEDICINE = TRACE ELEM MED
TRADITIO-STUDIES IN ANCIENT AND MEDIEVAL HISTORY THOUGHT AND RELIGION = TRADITIO
TRADITION-A JOURNAL OF ORTHODOX JEWISH THOUGHT = TRADITION
TRAFFIC = TRAFFIC
TRAFFIC FLOW THEORY = TRANSPORT RES REC
TRAFFIC SAFETY = TRAFFIC SAF
TRAFFIC SAFETY = TRANSPORT RES REC
TRAINING & DEVELOPMENT = TRAINING DEV
TRANSACTIONS AMERICAN SOCIETY FOR ARTIFICIAL INTERNAL ORGANS = T AM SOC ART INT ORG
TRANSACTIONS AND JOURNAL OF THE BRITISH CERAMIC SOCIETY = BRIT CERAM TRANS J
TRANSACTIONS OF NATIONAL RESEARCH INSTITUTE FOR METALS = T NATL RES I MET
TRANSACTIONS OF NONFERROUS METALS SOCIETY OF CHINA = T NONFERR METAL SOC
TRANSACTIONS OF THE AMERICAN ENTOMOLOGICAL SOCIETY = T AM ENTOMOL SOC
TRANSACTIONS OF THE AMERICAN FISHERIES SOCIETY = T AM FISH SOC
TRANSACTIONS OF THE AMERICAN MATHEMATICAL SOCIETY = T AM MATH SOC
TRANSACTIONS OF THE AMERICAN MICROSCOPICAL SOCIETY = T AM MICROSC SOC
TRANSACTIONS OF THE AMERICAN NEUROLOGICAL ASSOCIATION = T AM NEUROL ASSOC
TRANSACTIONS OF THE AMERICAN NUCLEAR SOCIETY = T AM NUCL SOC
TRANSACTIONS OF THE AMERICAN PHILOLOGICAL ASSOCIATION = T AM PHILOL ASSOC
TRANSACTIONS OF THE AMERICAN PHILOSOPHICAL SOCIETY = T AM PHILOS SOC
TRANSACTIONS OF THE ANCIENT MONUMENTS SOCIETY = T ANCIENT MONUMENT
TRANSACTIONS OF THE ASAE = T ASAE
TRANSACTIONS OF THE ASSOCIATION OF AMERICAN PHYSICIANS = T ASSOC AM PHYSICIAN
TRANSACTIONS OF THE BRITISH MYCOLOGICAL SOCIETY = T BRIT MYCOL SOC
TRANSACTIONS OF THE CANADIAN SOCIETY FOR MECHANICAL ENGINEERING = T CAN SOC MECH ENG
TRANSACTIONS OF THE CHARLES S PEIRCE SOCIETY = T C S PEIRCE SOC
TRANSACTIONS OF THE INDIAN INSTITUTE OF METALS = T INDIAN I METALS
TRANSACTIONS OF THE INSTITUTE OF BRITISH GEOGRAPHERS = T I BRIT GEOGR
TRANSACTIONS OF THE INSTITUTE OF MEASUREMENT AND CONTROL = T I MEAS CONTROL
TRANSACTIONS OF THE INSTITUTE OF METAL FINISHING = T I MET FINISH
TRANSACTIONS OF THE INSTITUTION OF CHEMICAL ENGINEERS = T I CHEM ENG-LOND
TRANSACTIONS OF THE INSTITUTION OF MINING AND METALLURGY SECTION A-MINING INDUSTRY = T I MIN METALL A
TRANSACTIONS OF THE INSTITUTION OF MINING AND METALLURGY SECTION B-APPLIED EARTH SCIENCE = T I MIN METALL B
TRANSACTIONS OF THE INSTITUTION OF MINING AND METALLURGY SECTION C-MINERAL PROCESSING AND EXTRACTIVE METALLURGY = T I MIN METALL C
TRANSACTIONS OF THE IRON AND STEEL INSTITUTE OF JAPAN = T IRON STEEL I JPN
TRANSACTIONS OF THE JAPAN INSTITUTE OF METALS = T JPN I MET
TRANSACTIONS OF THE JAPAN SOCIETY FOR AERONAUTICAL AND SPACE SCIENCES = T JPN SOC AERONAUT S
TRANSACTIONS OF THE METAL FINISHERS ASSOCIATION OF INDIA = T MET FINISH INDIA
TRANSACTIONS OF THE MYCOLOGICAL SOCIETY OF JAPAN = T MYCOL SOC JPN
TRANSACTIONS OF THE NORTH AMERICAN WILDLIFE AND NATURAL RESOURCES CONFERENCE = T N AM WILDL NAT RES
TRANSACTIONS OF THE OPHTHALMOLOGICAL SOCIETIES OF THE UNITED KINGDOM = T OPHTHAL SOC UK
TRANSACTIONS OF THE PHILOLOGICAL SOCIETY = T PHILOL SOC
TRANSACTIONS OF THE ROYAL SOCIETY OF EDINBURGH-EARTH SCIENCES = T ROY SOC EDIN-EARTH
TRANSACTIONS OF THE ROYAL SOCIETY OF SOUTH AFRICA = T ROY SOC S AFR
TRANSACTIONS OF THE ROYAL SOCIETY OF SOUTH AUSTRALIA = T ROY SOC SOUTH AUST
TRANSACTIONS OF THE ROYAL SOCIETY OF TROPICAL MEDICINE AND HYGIENE = T ROY SOC TROP MED H
TRANSACTIONS OF THE SOCIETY FOR COMPUTER SIMULATION = T SOC COMPUT SIMUL
TRANSACTIONS OF THE SOCIETY FOR COMPUTER SIMULATION INTERNATIONAL = T SOC COMPUT SIMUL I
TRANSACTIONS OF THE TOKYO UNIVERSITY OF FISHERIES-TOKYO SUISAN DAIGAKU TOKUBETSU KENKYU HOKOKU = T TOKYO UNIV FISH
TRANSFORMATION GROUPS = TRANSFORM GROUPS
TRANSFUSION = TRANSFUSION
TRANSFUSION CLINIQUE ET BIOLOGIQUE = TRANSFUS CLIN BIOL
TRANSFUSION MEDICINE = TRANSFUSION MED
TRANSFUSION MEDICINE REVIEWS = TRANSFUS MED REV
TRANSFUSION SCIENCE = TRANSFUS SCI
TRANSGENIC RESEARCH = TRANSGENIC RES
TRANSGENICS = TRANSGENICS
TRANSIT = TRANSPORT RES REC
TRANSITION METAL CHEMISTRY = TRANSIT METAL CHEM
TRANSLATION REVIEW = TRANSLATION REV
TRANSMISSION & DISTRIBUTION = TRANSM DISTRIB
TRANSPLANT IMMUNOLOGY = TRANSPL IMMUNOL
TRANSPLANT INTERNATIONAL = TRANSPLANT INT
TRANSPLANTATION = TRANSPLANTATION
TRANSPLANTATION PROCEEDINGS = TRANSPLANT P
TRANSPORT IN POROUS MEDIA = TRANSPORT POROUS MED
TRANSPORT REVIEWS = TRANSPORT REV
TRANSPORT THEORY AND STATISTICAL PHYSICS = TRANSPORT THEOR STAT
TRANSPORTATION = TRANSPORTATION
TRANSPORTATION ENGINEERING JOURNAL OF ASCE = TRANSPORT ENG-J ASCE
TRANSPORTATION FINANCE, ECONOMICS, AND MANAGEMENT = TRANSPORT RES REC
TRANSPORTATION JOURNAL = TRANSPORT J
TRANSPORTATION PLANNING AND TECHNOLOGY = TRANSPORT PLAN TECHN
TRANSPORTATION QUARTERLY = TRANSPORT Q
TRANSPORTATION RESEARCH PART A-POLICY AND PRACTICE = TRANSPORT RES A-POL
TRANSPORTATION RESEARCH PART B-METHODOLOGICAL = TRANSPORT RES B-METH
TRANSPORTATION RESEARCH PART C-EMERGING TECHNOLOGIES = TRANSPORT RES C-EMER
TRANSPORTATION RESEARCH PART D-TRANSPORT AND ENVIRONMENT = TRANSPORT RES D-TR E
TRANSPORTATION RESEARCH PART E-LOGISTICS AND TRANSPORTATION REVIEW = TRANSPORT RES E-LOG
TRANSPORTATION RESEARCH RECORD = TRANSPORT RES REC
TRANSPORTATION SCIENCE = TRANSPORT SCI
TRAVAIL HUMAIN = TRAV HUMAIN
TREE PHYSIOLOGY = TREE PHYSIOL
TREES-STRUCTURE AND FUNCTION = TREES-STRUCT FUNCT
TRENDS IN BIOCHEMICAL SCIENCES = TRENDS BIOCHEM SCI
TRENDS IN BIOTECHNOLOGY = TRENDS BIOTECHNOL
TRENDS IN CARDIOVASCULAR MEDICINE = TRENDS CARDIOVAS MED
TRENDS IN CELL BIOLOGY = TRENDS CELL BIOL
TRENDS IN COGNITIVE SCIENCES = TRENDS COGN SCI
TRENDS IN ECOLOGY & EVOLUTION = TRENDS ECOL EVOL
TRENDS IN ENDOCRINOLOGY AND METABOLISM = TRENDS ENDOCRIN MET
TRENDS IN FOOD SCIENCE & TECHNOLOGY = TRENDS FOOD SCI TECH
TRENDS IN GENETICS = TRENDS GENET
TRENDS IN GLYCOSCIENCE AND GLYCOTECHNOLOGY = TRENDS GLYCOSCI GLYC
TRENDS IN MICROBIOLOGY = TRENDS MICROBIOL
TRENDS IN NEUROSCIENCES = TRENDS NEUROSCI
TRENDS IN PHARMACOLOGICAL SCIENCES = TRENDS PHARMACOL SCI
TRENDS IN PLANT SCIENCE = TRENDS PLANT SCI
TRENDS IN POLYMER SCIENCE = TRENDS POLYM SCI
TRIAL = TRIAL
TRIBOLOGY INTERNATIONAL = TRIBOL INT
TRIBOLOGY LETTERS = TRIBOL LETT
TRIBOLOGY TRANSACTIONS = TRIBOL T
TRIMESTRE ECONOMICO = TRIMEST ECON
TRIQUARTERLY = TRIQUARTERLY
TRIVIUM = TRIVIUM
TROPENLANDWIRT = TROPENLANDWIRT
TROPENMEDIZIN UND PARASITOLOGIE = TROPENMED PARASITOL
TROPICAL AGRICULTURE = TROP AGR
TROPICAL AND GEOGRAPHICAL MEDICINE = TROP GEOGR MED
TROPICAL ANIMAL HEALTH AND PRODUCTION = TROP ANIM HEALTH PRO
TROPICAL DOCTOR = TROP DOCT
TROPICAL GRASSLANDS = TROP GRASSLANDS
TROPICAL MEDICINE & INTERNATIONAL HEALTH = TROP MED INT HEALTH
TROPICAL MEDICINE AND PARASITOLOGY = TROP MED PARASITOL
TROPICAL PEST MANAGEMENT = TROP PEST MANAGE
TROPICAL ZOOLOGY = TROP ZOOL
TSCHERMAKS MINERALOGISCHE UND PETROGRAPHISCHE MITTEILUNGEN = TSCHER MINER PETROG
TSI-TECHNIQUE ET SCIENCE INFORMATIQUES = TSI-TECH SCI INF
TSITOLOGIYA = TSITOLOGIYA+
TSITOLOGIYA I GENETIKA = TSITOL GENET+
TUBERCLE = TUBERCLE
TUBERCLE AND LUNG DISEASE = TUBERCLE LUNG DIS
TULSA STUDIES IN WOMENS LITERATURE = TULSA STUD WOMEN LIT
TUMOR BIOLOGY = TUMOR BIOL
TUMOR TARGETING = TUMOR TARGET
TUMORDIAGNOSTIK & THERAPIE = TUMORDIAGN THER
TUMORI = TUMORI
TUMOUR BIOLOGY = TUMOR BIOL
TUMOUR BIOLOGY = TUMOUR BIOL
TUNNELLING AND UNDERGROUND SPACE TECHNOLOGY = TUNN UNDERGR SP TECH
TURBOMACHINERY INTERNATIONAL = TURBOMACH INT
TURK PSIKOLOJI DERGISI = TURK PSIKOL DERG
TURKISH JOURNAL OF CHEMISTRY = TURK J CHEM
TURKISH JOURNAL OF PEDIATRICS = TURKISH J PEDIATR
TURKISH JOURNAL OF VETERINARY & ANIMAL SCIENCES = TURK J VET ANIM SCI
TURRIALBA = TURRIALBA
TWENTIETH CENTURY LITERATURE = TWENTIETH CENT LIT
TWO-YEAR COLLEGE MATHEMATICS JOURNAL = TWO-YEAR COLL MATH J
