UCLA LAW REVIEW = UCLA LAW REV
UCLA SYMPOSIA ON MOLECULAR AND CELLULAR BIOLOGY = UCLA SYMP MOL CELL B
UKRAINSKII BIOKHIMICHESKII ZHURNAL = UKR BIOKHIM ZH+
UKRAINSKII FIZICHESKII ZHURNAL = UKR FIZ ZH+
UKRAINSKII KHIMICHESKII ZHURNAL = UKR KHIM ZH+
ULSTER FOLKLIFE = ULSTER FOLKLIFE
ULSTER MEDICAL JOURNAL = ULSTER MED J
ULTIMATE REALITY AND MEANING = ULTIMATE REAL MEAN
ULTRAMICROSCOPY = ULTRAMICROSCOPY
ULTRASCHALL IN DER MEDIZIN = ULTRASCHALL MED
ULTRASONIC IMAGING = ULTRASONIC IMAGING
ULTRASONICS = ULTRASONICS
ULTRASONICS SONOCHEMISTRY = ULTRASON SONOCHEM
ULTRASOUND IN MEDICINE AND BIOLOGY = ULTRASOUND MED BIOL
ULTRASOUND IN OBSTETRICS & GYNECOLOGY = ULTRASOUND OBST GYN
ULTRASTRUCTURAL PATHOLOGY = ULTRASTRUCT PATHOL
UMSCHAU = UMSCHAU
UMSCHAU DAS WISSENSCHAFTSMAGAZIN = UMSCHAU
UNDERGROUND SPACE = UNDERGROUND SPACE
UNDERSEA & HYPERBARIC MEDICINE = UNDERSEA HYPERBAR M
UNDERSEA BIOMEDICAL RESEARCH = UNDERSEA BIOMED RES
UNDERWATER TECHNOLOGY = UNDERWATER TECHNOL
UNFALLCHIRURG = UNFALLCHIRURG
UNFALLHEILKUNDE-TRAUMATOLOGY = UNFALLHEILKUNDE
UNIFIED MODELING LANGUAGE = LECT NOTES COMPUT SC
UNION MEDICALE DU CANADA = UNION MED CAN
UNIVERSITY COMPUTING = U COMPUT
UNIVERSITY OF CALIFORNIA DIVISION OF AGRICULTURAL SCIENCES BULLETIN = U CALIF AGR SCI BULL
UNIVERSITY OF CHICAGO LAW REVIEW = U CHICAGO LAW REV
UNIVERSITY OF CINCINNATI LAW REVIEW = U CINCI LAW REV
UNIVERSITY OF ILLINOIS LAW REVIEW = U ILLINOIS LAW REV
UNIVERSITY OF LOUISVILLE JOURNAL OF FAMILY LAW = U LOUISVILLE J FAM L
UNIVERSITY OF PENNSYLVANIA JOURNAL OF INTERNATIONAL BUSINESS LAW = U PENN J INT BUS LAW
UNIVERSITY OF PENNSYLVANIA JOURNAL OF INTERNATIONAL ECONOMIC LAW = U PA J INT ECON LAW
UNIVERSITY OF PENNSYLVANIA LAW REVIEW = U PENN LAW REV
UNIVERSITY OF PITTSBURGH LAW REVIEW = U PITT LAW REV
UNIVERSITY OF TORONTO QUARTERLY = U TORONTO QUART
UPSALA JOURNAL OF MEDICAL SCIENCES = UPSALA J MED SCI
URANIUM = URANIUM
URBAN AFFAIRS REVIEW = URBAN AFF REV
URBAN ECOLOGY = URBAN ECOL
URBAN EDUCATION = URBAN EDUC
URBAN GEOGRAPHY = URBAN GEOGR
URBAN HISTORY REVIEW-REVUE D HISTOIRE URBAINE = URBAN HIST REV
URBAN LAWYER = URBAN LAWYER
URBAN STUDIES = URBAN STUD
UREMIA INVESTIGATION = UREMIA INVEST
UROLOGE A = UROLOGE A
UROLOGE-AUSGABE A = UROLOGE A
UROLOGIA INTERNATIONALIS = UROL INT
UROLOGIC CLINICS OF NORTH AMERICA = UROL CLIN N AM
UROLOGIC ONCOLOGY = UROL ONCOL
UROLOGIC RADIOLOGY = UROL RADIOL
UROLOGICAL RESEARCH = UROL RES
UROLOGY = UROLOGY
USDA FOREST SERVICE INTERMOUNTAIN RESEARCH STATION RESEARCH PAPER = USDA FOR SERV INT R
USDA FOREST SERVICE NORTH CENTRAL FOREST EXPERIMENT STATION RESEARCH PAPER = USDA FOR SERV NC R P
USDA FOREST SERVICE NORTHEASTERN FOREST EXPERIMENT STATION RESEARCH PAPER = USDA FOR SERV NE RES
USDA FOREST SERVICE NORTHEASTERN RESEARCH STATION RESEARCH PAPER = USDA FOR SERV NE RES
USDA FOREST SERVICE PACIFIC NORTHWEST RESEARCH STATION RESEARCH PAPER = USDA FOR SERV PNW RE
USDA FOREST SERVICE PACIFIC SOUTHWEST RESEARCH STATION RESEARCH PAPER = USDA FOR SERV PSW R
USDA FOREST SERVICE ROCKY MOUNTAIN FOREST AND RANGE EXPERIMENT STATION RESEARCH PAPER = USDA FOR SERV RM RES
USDA FOREST SERVICE ROCKY MOUNTAIN RESEARCH STATION RESEARCH PAPER RMRS = USDA FOR SERV RM R S
USDA FOREST SERVICE SOUTHEASTERN FOREST EXPERIMENT STATION RESEARCH PAPER = USDA FOR SERV SE RES
USDA FOREST SERVICE SOUTHERN FOREST EXPERIMENT STATION RESEARCH PAPER = USDA FOR SERV SO RES
USER MODELING AND USER-ADAPTED INTERACTION = USER MODEL USER-ADAP
USPEKHI FIZICHESKIKH NAUK = USP FIZ NAUK+
USPEKHI KHIMII = USP KHIM+
USSR COMPUTATIONAL MATHEMATICS AND MATHEMATICAL PHYSICS = USSR COMP MATH MATH+
UTAH AGRICULTURAL EXPERIMENT STATION RESEARCH BULLETIN = UTAH AES RES BULL
UTAH AGRICULTURAL EXPERIMENT STATION RESEARCH REPORT = UTAH AES RES REP
UTAH SCIENCE = UTAH SCI
UTILITAS MATHEMATICA = UTILITAS MATHEMATICA
