VACCINE = VACCINE
VACUUM = VACUUM
VAKUUM-TECHNIK = VAKUUM-TECH
VANDERBILT LAW REVIEW = VANDERBILT LAW REV
VASA-JOURNAL OF VASCULAR DISEASES = VASA-J VASCULAR DIS
VASCULAR MEDICINE = VASC MED
VASCULAR SURGERY = VASCULAR SURG
VEGETATIO = VEGETATIO
VEGETATION HISTORY AND ARCHAEOBOTANY = VEG HIST ARCHAEOBOT
VEHICLE SYSTEM DYNAMICS = VEHICLE SYST DYN
VELIGER = VELIGER
VENEREOLOGY-THE INTERDISCIPLINARY INTERNATIONAL JOURNAL OF SEXUAL HEALTH = VENEREOLOGY
VERBATIM = VERBATIM
VERHALTENSTHERAPIE = VERHALTENSTHERAPIE
VERIFICHE = VERIFICHE
VEROFFENTLICHUNGEN AUS DER PATHOLOGIE-PROGRESS IN PATHOLOGY = VEROFF PATHOL
VERPACKUNGS RUNDSCHAU = VERPACK RUNDSCH
VERTEBRATA PALASIATICA = VERTEBRAT PALASIATIC
VERTICA = VERTICA
VESTNIK AKADEMII MEDITSINSKIKH NAUK SSSR = VESTN AKAD MED NAUK+
VESTNIK AKADEMII NAUK SSSR = VESTN AN SSSR+
VESTNIK DERMATOLOGII I VENEROLOGII = VESTN DERMATOL VENER
VESTNIK KHIRURGII IMENI I I GREKOVA = VESTN KHIR IM GREKOV
VESTNIK LENINGRADSKOGO UNIVERSITETA SERIYA FIZIKA KHIMIYA = VESTN LENIN U FIZ KH
VESTNIK LENINGRADSKOGO UNIVERSITETA SERIYA MATEMATIKA MEKHANIKA ASTRONOMIYA = VESTN LENIN U MMA
VESTNIK MOSKOVSKOGO UNIVERSITETA SERIYA 1 MATEMATIKA MEKHANIKA = VESTN MOSK U MAT M+
VESTNIK MOSKOVSKOGO UNIVERSITETA SERIYA 2 KHIMIYA = VESTN MOSK U KHIM+
VESTNIK MOSKOVSKOGO UNIVERSITETA SERIYA 3 FIZIKA ASTRONOMIYA = VESTN MOSK U FIZ AS+
VESTNIK OFTALMOLOGII = VESTN OFTALMOL
VESTNIK ROSSIISKOI AKADEMII MEDITSINSKIKH NAUK = VESTN ROS AKAD MED+
VESTNIK ROSSIISKOI AKADEMII NAUK = VESTN ROS AKAD NAUK+
VETERINARNI MEDICINA = VET MED-CZECH
VETERINARSKI ARHIV = VET ARHIV
VETERINARY & COMPARATIVE OPHTHALMOLOGY = VET COMP OPHTHALMOL
VETERINARY AND COMPARATIVE ORTHOPAEDICS AND TRAUMATOLOGY = VET COMP ORTHOPAED
VETERINARY AND HUMAN TOXICOLOGY = VET HUM TOXICOL
VETERINARY CLINICAL PATHOLOGY = VET CLIN PATH
VETERINARY CLINICS OF NORTH AMERICA-EQUINE PRACTICE = VET CLIN N AM-EQUINE
VETERINARY CLINICS OF NORTH AMERICA-FOOD ANIMAL PRACTICE = VET CLIN N AM-FOOD A
VETERINARY CLINICS OF NORTH AMERICA-LARGE ANIMAL PRACTICE = VET CLIN N AM-LARGE
VETERINARY CLINICS OF NORTH AMERICA-SMALL ANIMAL PRACTICE = VET CLIN N AM-SMALL
VETERINARY DERMATOLOGY = VET DERMATOL
VETERINARY ECONOMICS = VET ECON
VETERINARY IMMUNOLOGY AND IMMUNOPATHOLOGY = VET IMMUNOL IMMUNOP
VETERINARY JOURNAL = VET J
VETERINARY MEDICINE = VET MED-US
VETERINARY MEDICINE & SMALL ANIMAL CLINICIAN = VET MED SM ANIM CLIN
VETERINARY MICROBIOLOGY = VET MICROBIOL
VETERINARY PARASITOLOGY = VET PARASITOL
VETERINARY PATHOLOGY = VET PATHOL
VETERINARY PRACTICE STAFF = VET PRACT STAFF
VETERINARY QUARTERLY = VET QUART
VETERINARY RADIOLOGY = VET RADIOLOGY
VETERINARY RADIOLOGY & ULTRASOUND = VET RADIOL ULTRASOUN
VETERINARY RECORD = VET REC
VETERINARY RESEARCH = VET RES
VETERINARY RESEARCH COMMUNICATIONS = VET RES COMMUN
VETERINARY SURGERY = VET SURG
VETERINARY TECHNICIAN = VET TECH
VETUS TESTAMENTUM = VETUS TESTAMENTUM
VIBRATIONAL SPECTROSCOPY = VIB SPECTROSC
VICTORIAN LITERATURE AND CULTURE = VICTORIAN LIT CULT
VICTORIAN NEWSLETTER = VICTORIAN NEWSL
VICTORIAN POETRY = VICTORIAN POETRY
VICTORIAN STUDIES = VICTORIAN STUD
VIDE-SCIENCE TECHNIQUE ET APPLICATIONS = VIDE
VIDEODISC AND OPTICAL DISK = VIDEODISC OPT DISK
VIDEODISC-VIDEOTEX = VIDEODISC-VIDEOTEX
VIE ET MILIEU-LIFE AND ENVIRONMENT = VIE MILIEU
VIE MEDICALE AU CANADA FRANCAIS = VIE MED CAN FR
VIERTELJAHRSHEFTE FUR ZEITGESCHICHTE = VIERTELJAHR ZEITGES
VIGILIAE CHRISTIANAE = VIGILIAE CHRISTIAN
VIRAL IMMUNOLOGY = VIRAL IMMUNOL
VIRCHOWS ARCHIV A-PATHOLOGICAL ANATOMY AND HISTOPATHOLOGY = VIRCHOWS ARCH A
VIRCHOWS ARCHIV B-CELL PATHOLOGY INCLUDING MOLECULAR PATHOLOGY = VIRCHOWS ARCH B
VIRCHOWS ARCHIV-AN INTERNATIONAL JOURNAL OF PATHOLOGY = VIRCHOWS ARCH
VIRGINIA AGRICULTURAL EXPERIMENT STATION BULLETIN = VA AGR EXP STAT B
VIRGINIA LAW REVIEW = VA LAW REV
VIRGINIA MAGAZINE OF HISTORY AND BIOGRAPHY = VA MAG HIST BIOG
VIRGINIA POLYTECHNIC INSTITUTE EXTENSION SERVICE-VIRGINIA AGRICULTURAL ECONOMICS = VA POLY I EXT SERV V
VIRGINIA QUARTERLY REVIEW = VA QUART REV
VIROLOGY = VIROLOGY
VIRUS GENES = VIRUS GENES
VIRUS RESEARCH = VIRUS RES
VISIBLE LANGUAGE = VISIBLE LANG
VISION RESEARCH = VISION RES
VISION TECNOLOGICA = VIS TECNOL
VISTAS IN ASTRONOMY = VISTAS ASTRON
VISUAL COGNITION = VIS COGN
VISUAL COMPUTER = VISUAL COMPUT
VISUAL NEUROSCIENCE = VISUAL NEUROSCI
VITAMINS AND HORMONES-ADVANCES IN RESEARCH AND APPLICATIONS = VITAM HORM
VITIS = VITIS
VIVARIUM-AN INTERNATIONAL JOURNAL FOR THE PHILOSOPHY AND INTELLECTUAL LIFE OF THE MIDDLE AGES AND RENAISSANCE = VIVARIUM
VLAAMS DIERGENEESKUNDIG TIJDSCHRIFT = VLAAMS DIERGEN TIJDS
VLDB JOURNAL = VLDB J
VLSI DESIGN = VLSI DES
VLSI SYSTEMS DESIGN = VLSI SYST DES
VOIX & IMAGES = VOIX IMAGE
VOLKSKUNDE = VOLKSKUNDE
VOLTA REVIEW = VOLTA REV
VOM WASSER = VOM WASSER
VOPROSY FILOSOFII = VOP FILOS
VOPROSY ISTORII = VOP ISTORII
VOPROSY MEDITSINSKOI KHIMII = VOP MED KHIM
VOPROSY ONKOLOGII = VOP ONKOL+
VOPROSY PSIKHOLOGII = VOP PSIKHOL+
VOPROSY VIRUSOLOGII = VOP VIRUSOL+
VOX SANGUINIS = VOX SANG
VRACHEBNOE DELO = VRACHEBNOE DELO
VYSOKOMOLEKULYARNYE SOEDINENIYA SERIYA A = VYSOKOMOL SOEDIN A+
VYSOKOMOLEKULYARNYE SOEDINENIYA SERIYA A & SERIYA B = VYSOKOMOL SOEDIN
VYSOKOMOLEKULYARNYE SOEDINENIYA SERIYA B = VYSOKOMOL SOEDIN B
