WAFFEN-UND KOSTUMKUNDE = WAFFEN-KOSTUMKUNDE
WALT WHITMAN QUARTERLY REVIEW = WALT WHITMAN Q REV
WAR IN HISTORY = WAR HIST
WARME UND STOFFUBERTRAGUNG-THERMO AND FLUID DYNAMICS = WARME STOFFUBERTRAG
WASHINGTON LAW REVIEW = WASH LAW REV
WASHINGTON QUARTERLY = WASH QUART
WASTE MANAGEMENT = WASTE MANAGE
WASTE MANAGEMENT & RESEARCH = WASTE MANAGE RES
WATER AIR AND SOIL POLLUTION = WATER AIR SOIL POLL
WATER ENVIRONMENT RESEARCH = WATER ENVIRON RES
WATER INTERNATIONAL = WATER INT
WATER POLLUTION CONTROL = WATER POLLUT CONTROL
WATER QUALITY RESEARCH JOURNAL OF CANADA = WATER QUAL RES J CAN
WATER RESEARCH = WATER RES
WATER RESOURCES BULLETIN = WATER RESOUR BULL
WATER RESOURCES MANAGEMENT = WATER RESOUR MANAG
WATER RESOURCES RESEARCH = WATER RESOUR RES
WATER SA = WATER SA
WATER SCIENCE AND TECHNOLOGY = WATER SCI TECHNOL
WATER SCIENCE REVIEWS = WATER SCI REV
WATER SERVICES = WATER SERV
WATER SUPPLY & MANAGEMENT = WATER SUPPLY MANAGE
WATER-ENGINEERING & MANAGEMENT = WATER ENG MANAG
WATERBIRDS = WATERBIRDS
WAVE ELECTRONICS = WAVE ELECTRON
WAVE MOTION = WAVE MOTION
WAVES IN RANDOM MEDIA = WAVE RANDOM MEDIA
WEAR = WEAR
WEATHER AND FORECASTING = WEATHER FORECAST
WEATHERWISE = WEATHERWISE
WEED RESEARCH = WEED RES
WEED SCIENCE = WEED SCI
WEED TECHNOLOGY = WEED TECHNOL
WEIMARER BEITRAGE = WEIMARER BEITR
WELDING DESIGN & FABRICATION = WELD DESIGN FABR
WELDING JOURNAL = WELD J
WELDING PRODUCTION = WELD PROD+
WELSH HISTORY REVIEW = WELSH HIST REV
WELT DER SLAVEN-HALBJAHRESSCHRIFT FUR SLAVISTIK = WELT SLAVEN
WELTWIRTSCHAFTLICHES ARCHIV-REVIEW OF WORLD ECONOMICS = WELTWIRTSCH ARCH
WERKSTATTSTECHNIK ZEITSCHRIFT FUR INDUSTRIELLE FERTIGUNG = WT-Z IND FERTIGUNG
WERKSTOFFE UND KORROSION-MATERIALS AND CORROSION = WERKST KORROS
WEST INDIAN MEDICAL JOURNAL = W INDIAN MED J
WEST VIRGINIA MEDICAL JOURNAL = W VA MED J
WESTERLY = WESTERLY
WESTERN AMERICAN LITERATURE = WESTERN AM LIT
WESTERN ELECTRIC ENGINEER = WESTERN ELECTR ENG
WESTERN FOLKLORE = WESTERN FOLKLORE
WESTERN HISTORICAL QUARTERLY = WESTERN HIST QUART
WESTERN HUMANITIES REVIEW = WESTERN HUM REV
WESTERN JOURNAL OF AGRICULTURAL ECONOMICS = WESTERN J AGR ECON
WESTERN JOURNAL OF COMMUNICATION = WESTERN J COMM
WESTERN JOURNAL OF MEDICINE = WESTERN J MED
WESTERN JOURNAL OF NURSING RESEARCH = WESTERN J NURS RES
WESTERN NORTH AMERICAN NATURALIST = WEST N AM NATURALIST
WETLANDS = WETLANDS
WHO CHRONICLE = WHO CHRON
WHO EXPERT COMMITTE ON DRUG DEPENDENCE - 31ST REPORT = WHO TECH REP SER
WHO EXPERT COMMITTEE ON BIOLOGICAL STANDARDIZATION = WHO TECH REP SER
WHO EXPERT COMMITTEE ON BIOLOGICAL STANDARDIZATION - 48TH REPORT = WHO TECH REP SER
WHO EXPERT COMMITTEE ON BIOLOGICAL STANDARDIZATION - FORTY-SEVENTH REPORT = WHO TECH REP SER
WHO EXPERT COMMITTEE ON BIOLOGICAL STANDARDIZATION, FORTY-FIFTH REPORT = WHO TECH REP SER
WHO EXPERT COMMITTEE ON BIOLOGICAL STANDARDIZATION, FORTY-FOURTH REPORT = WHO TECH REP SER
WHO EXPERT COMMITTEE ON DRUG DEPENDENCE - 28TH REPORT = WHO TECH REP SER
WHO EXPERT COMMITTEE ON DRUG DEPENDENCE - 29TH REPORT = WHO TECH REP SER
WHO EXPERT COMMITTEE ON DRUG DEPENDENCE - 30TH REPORT = WHO TECH REP SER
WHO EXPERT COMMITTEE ON LEPROSY - 7TH REPORT = WHO TECH REP SER
WHO EXPERT COMMITTEE ON SPECIFICATIONS FOR PHARMACEUTICAL PREPARATIONS = WHO TECH REP SER
WHO EXPERT COMMITTEE ON SPECIFICATIONS FOR PHARMACEUTICAL PREPARATIONS - THIRTY-FIFTH REPORT = WHO TECH REP SER
WHO EXPERT COMMITTEE ON SPECIFICATIONS FOR PHARMACEUTICAL PREPARATIONS, 33RD REPORT = WHO TECH REP SER
WHO TECHNICAL REPORT SERIES = WHO TECH REP SER
WIDE ANGLE-A QUARTERLY JOURNAL OF FILM HISTORY THEORY CRITICISM & PRACTICE = WIDE ANGLE
WIENER KLINISCHE WOCHENSCHRIFT = WIEN KLIN WOCHENSCHR
WIENER MEDIZINISCHE WOCHENSCHRIFT = WIEN MED WOCHENSCHR
WIENER SLAVISTISCHES JAHRBUCH = WIEN SLAV JAHRB
WIENER TIERARZTLICHE MONATSSCHRIFT = WIEN TIERARZTL MONAT
WILDERNESS = WILDERNESS
WILDERNESS & ENVIRONMENTAL MEDICINE = WILD ENVIRON MED
WILDLIFE BIOLOGY = WILDLIFE BIOL
WILDLIFE MONOGRAPHS = WILDLIFE MONOGR
WILDLIFE RESEARCH = WILDLIFE RES
WILDLIFE SOCIETY BULLETIN = WILDLIFE SOC B
WILHELM ROUXS ARCHIVES OF DEVELOPMENTAL BIOLOGY = ROUX ARCH DEV BIOL
WILLIAM AND MARY QUARTERLY = WILLIAM MARY QUART
WILSON BULLETIN = WILSON BULL
WILSON LIBRARY BULLETIN = WILSON LIBR BULL
WIND AND STRUCTURES = WIND STRUCT
WINTERTHUR PORTFOLIO-A JOURNAL OF AMERICAN MATERIAL CULTURE = WINTERTHUR PORTFOLIO
WIRE JOURNAL INTERNATIONAL = WIRE J INT
WIRELESS NETWORKS = WIREL NETW
WIRELESS PERSONAL COMMUNICATIONS = WIRELESS PERS COMMUN
WIRELESS WORLD = ELECTRON WIRELESS W
WIRTSCHAFTSINFORMATIK = WIRTSCHAFTSINF
WISCONSIN COLLEGE OF AGRICULTURE AND LIFE SCIENCES RESEARCH BULLETIN = WISC COLL ALS RES B
WISCONSIN LAW REVIEW = WISC LAW REV
WISCONSIN MEDICAL JOURNAL = WISC MED J
WOCHENBLATT FUR PAPIERFABRIKATION = WOCHENBL PAPIERFABR
WOMANS ART JOURNAL = WOMAN ART J
WOMEN & HEALTH = WOMEN HEALTH
WOMEN & POLITICS = WOMEN POLIT
WOMEN & THERAPY = WOMEN THER
WOMENS HEALTH ISSUES = WOMEN HEALTH ISS
WOMENS HISTORY REVIEW = WOMEN HIST REV
WOMENS STUDIES INTERNATIONAL FORUM = WOMEN STUD INT FORUM
WOMENS STUDIES-AN INTERDISCIPLINARY JOURNAL = WOMEN STUD
WOOD & WOOD PRODUCTS = WOOD WOOD PROD
WOOD AND FIBER = WOOD FIBER SCI
WOOD AND FIBER SCIENCE = WOOD FIBER SCI
WOOD SCIENCE = WOOD SCI
WOOD SCIENCE AND TECHNOLOGY = WOOD SCI TECHNOL
WOOL TECHNOLOGY AND SHEEP BREEDING = WOOL TECH SHEEP BREE
WORD & IMAGE = WORD IMAGE
WORD PROCESSING & INFORMATION SYSTEMS = WORD PROCESS INFORM
WORD-JOURNAL OF THE INTERNATIONAL LINGUISTIC ASSOCIATION = WORD
WORDSWORTH CIRCLE = WORDSWORTH CIRCLE
WORK AND OCCUPATIONS = WORK OCCUPATION
WORK AND STRESS = WORK STRESS
WORK EMPLOYMENT AND SOCIETY = WORK EMPLOY SOC
WORKFORCE = WORKFORCE
WORLD ANIMAL REVIEW = WORLD ANIM REV
WORLD ARCHAEOLOGY = WORLD ARCHAEOL
WORLD BANK ECONOMIC REVIEW = WORLD BANK ECON REV
WORLD BANK RESEARCH OBSERVER = WORLD BANK RES OBSER
WORLD CROPS = WORLD CROP
WORLD CROPS = WORLD CROPS
WORLD DEVELOPMENT = WORLD DEV
WORLD ECONOMY = WORLD ECON
WORLD HEALTH FORUM = WORLD HEALTH FORUM
WORLD JOURNAL OF GASTROENTEROLOGY = WORLD J GASTROENTERO
WORLD JOURNAL OF MICROBIOLOGY & BIOTECHNOLOGY = WORLD J MICROB BIOT
WORLD JOURNAL OF SURGERY = WORLD J SURG
WORLD JOURNAL OF UROLOGY = WORLD J UROL
WORLD LITERATURE TODAY = WORLD LITERATURE TOD
WORLD OF MUSIC = WORLD MUSIC
WORLD OIL = WORLD OIL
WORLD POLICY JOURNAL = WORLD POLICY J
WORLD POLITICS = WORLD POLIT
WORLD REVIEW OF NUTRITION AND DIETETICS = WORLD REV NUTR DIET
WORLD TODAY = WORLD TODAY
WORLD WASTES = WORLD WASTE
WORLD WATCH = WORLD WATCH
WORLDS POULTRY SCIENCE JOURNAL = WORLD POULTRY SCI J
WOUND REPAIR AND REGENERATION = WOUND REPAIR REGEN
WOUNDS-A COMPENDIUM OF CLINICAL RESEARCH AND PRACTICE = WOUNDS
WRITTEN COMMUNICATION = WRIT COMMUN
WYOMING AGRICULTURAL EXPERIMENT STATION BULLETIN = WYO AES BULL
WYOMING AGRICULTURAL EXPERIMENT STATION RESEARCH JOURNAL = WYO AES RES J
